!! Говорящие имена

Вьетнамский шахматист - Пень Пнём.
Бразильская певица - Оридо Пота.
Греческий посол - Слюнидополу.
Просто греческий нехороший человек - Наполнасракис.
Ереванский садовник - Газон Засеян.
Напористый испанец - Х#лиа Обнаглесиас.
Мексиканский фермер - Мачо Сранчо.
Римский полководец - Нолемоций.
Румынский посол - Сри Безтреску.
Румынский футболист - Взад Стамэску и Драчнука Спозаранку.
Турецкий музыкант - Обстул Х#ем-бей.
Турецкий музыкант - Обуглы Задом-бей.
Татарский строитель - Рулон Обоев.
Финская уборщица - Говорика Кудакакала.
Чешский ветеринар - Мацал Кошек.

!!! Болгарские Имена

Болгарский бизнесмен скупивший всю Яузу - Мойка Машин.
Болгарские проститутки - Стояна Ракова и Лежана Раздвиногова.
Болгарский строитель - Побелка Потолков.

!!! Германские Имена

Германский порноактёр - Ганс Трахенбюргер,
и германская порноактриса - Фрау Шлюхер.
Германская проститутка - Фригида Климакс.

!!! Грузинские Имена

Народный артист Грузии Уймураз Смогулия.
Грузинский бегун - Огого Добегулия.
Грузинский сантехник - Ванно Заржавели.
Грузинский владелец сортира - Подшум Набздел.
Грузинский террорист - Остачертели.

!!! Итальянские Имена

Сонет "Блювантина" из итальянской оперы "Рыгалетто".
Итальянская секретарша - Блядовина Ди Курваджио.
Итальянская порнозвезда - Минето Вротоберучи.
Итальянская парикмахерша - Франческо Расческа.
Итальянская - Кончино Менструяни.

!!! Кавказские Имена

Кавказский прокурор - Подсуд Злодеев.
Кавказские приступники - Подрыв Устоев, Поджог Сараев, Побег Злодеев и Атас Бандитов.
Кавказский продавец цветов - Букет Левкоев.
Кавказский подросток - Разгул Гормонов.
Кавказский садовник - Полив Побегов.
Кавказский фермер - Рекорд Hадоев и Дояр Муфлонов.
Чеченские строитель - Ремонт Фасадов и Обрез Обоев.
Азербайджанский музыкант - Обрыгай-углы.
Армянский винодел - Сутрапьян.

!!! Казахские Имена

Казахский космонавт - Космодром Байконуров.
Казахская бегунья - Атыкуда Атыгдежева.
Казахский авиаконструктор - Айбелив Айкенфлаев.
Казахский роботехник - Терминат Айлбибэков.
Казахский дегустатор - Кумыс Испакетов.
Казахский хулиган - Аяяй Ыыыев.
Казахский спортсмен - Баскетбол Волейболов.
Казахский холостяк - Мастур-Батыр.
Казахский рабочий - Гастар-Батыр.
Казахский продовец-консультант - Алкатель Телефонов.

!!! Китайские Имена

Китайский естествоиспытатель - Сунь Х#й Вчай.
и его напарник - Вынь СуХим.
и родной брат напарника - Вынь Сам Пей.

!!! Польские Имена

Польская певица - Стойка Ракова.
Польский боксёр - Вынька Мелочь.
Польская бегунья - Бзделка Пукова.
Польский разнорабочий - Мойка Полов.
Просто добрые поляки - Бздашек Западловский и Защекан Запи#детский

!!! Французские Имена

Французский повар - Жарь-Лук де Блюю.
и три французских повара де Лье, де Пье, де Блюе.
и знаменитый французский повар - Оливье Жюй де Глотай.

!!! Японские Имена

Японский футболист - Накатика Нае*ука.
и его напарник - Херанука Помячука.
Японский нищий - Наскребука Посусекам.
Просто японский нехороший человек - Немуто Несерио.
Японский боксер - Херанука Пое*алу.
Японский метрдотель - Мояхата Сыровата.
Японский сутенер - Комухари Комусиси.
Японский врач - Комуто Херовато.
Японский гонщик - Тояма Токанава.
Японский снайпер - Томимо Токосо.
Японский крестьянин - Накосика Сукасену.
Японский Сэнсей - Совсейдури Ох#ячу.
Японский наркоман - Пойдука Куранука.
Японский композитор - Толисику Толикаку.
Японская поэтесса - Ясука Такая.
Японская певица - Тохрипо Товизго и Ятасука Накомоде.
Японская песня о сомнении Атомули ядалато.
Японская пианистка - Херанука Пороялю.

!!! Самые неизвестные личности:

Килограмм Апельсинов, Камаз Отбросов, Погром Изгоев, Разгон Пикетов, Разбор Полётов, Распил Самшитов, Отлов Приматов, Набег Сипаев, Разгул Маньяков, Залог Успехов, Бидон Отстоев, Антикор Порогов, Угон Белазов, Вагон Кондомов, Пипец Пиндосов, Бекап Релизов, Забег Дибилов, Стреги Баранов, Толпа Отстоев, Ушат Помоев, Улов Налимов, Отряд Ковбоев, Захват Покоев, Исход Изгоев, Обвал Забоев, Угон Харлеев, Удел Плебеев, Камаз Отходов, Развод Супругов, Забег Дебилов, Парад Уродов, Вагон Гандонов, Отряд Дебилов, Улов Кальмаров, Черёд Застоев, Квартет Гобоев, Подшум Прибоев, Загул Старлеев, Друган Братанов, Учёт Расходов, Налог Сдоходов, Разбор Полетов, Мешок Лимонов, Обед Лемуров, Карман Пистонов, Прыжок Гибонов, Рожёк Потронов, Отжёр Мамонов, Разрез Батонов, Полет Фазанов, Косяк Пингвинов, Запой Гусаров, Сачок Малюсков, Поход Гераклов, Барак Монголов, Загон Баранов, Пропой Погонов, Отряд Маньяков, Тридня Запоев, Облом Пиндосов, Курган Отбросов, Полно Засосов, Говно Вопросов, Удар Морозов, Майор Сдопросов, Х#йдля Отсосов, Пробрал Поносов, Формат Поддосов, Атлон Безсбоев, Заплыв Матросов, Украл Снарядов, Порвал Боянов, Убой Мулатов, Бугор Нароев, Мешок Калымов, Замор Медведев, Косарь Безруков, Бегун Безногов, Моргун Безглазов, Разбор Завалов, Притулок Геев, Загон Шакалов, Творец Кошмаров, Поддел Продуктов, Учёт Пигмеев...