!! Список эпонимов

В этот список включаются эпонимы — имена собственные, ставшие именами нарицательными.

(:childlist:)

!!! Список

* Август — месяц (бывший «секстилий»), переименованный в 8 г. до н. э. римским сенатом в честь императора Октавиана Августа.
* Альмавива — плащ, названный по имени графа Альмавивы, персонажа «Женитьбы Фигаро».
* Алгоритм — набор инструкций, описывающих порядок действий. Слово происходит от имени крупнейшего математика Аль-Хорезми.
* Альфонс — мужчина, живущий на содержании женщины; по имени героя-любовника из комедии Александра Дюма (сына) «Мосье Альфонс».
* Арманьяк — крепкий спиртной напиток на основе виноградного спирта, от наименования местности Арманьяк.
* Атлас — сборник географических (а также астрономических, анатомических и т. п.) рисунков, карт, от собрания карт Меркатора «Atlas, Sive Cosmographicae Meditationes De Fabrica Mundi et Fabricati Figura», изданного в 1585 г., где на титульном листе был изображён титан Атлант (Атлас), держащий на плечах земной шар.
* Баббит — антифрикционный сплав, назван по имени изобретателя, Исаака Бэббита (Isaac Babbitt, 1799—1862)
* Балаклава — вид вязаной шапки, изобретённый британцами во время Крымской войны под городом Балаклава.
* Баян — музыкальный инструмент, названный в честь древнерусского сказителя Бояна (Баяна).
* Батист — тонкая ткань, выпуск которой, по легенде, был начат в XIII в. во Фландрии неким Баптистом из Камбрэ.
* Бедекер — путеводитель; от имени немецкого издателя Карла Бедекера (1801—1859).
* Бендикс — обгонная муфта стартёра, название происходит от фирмы Bendix и её основателя, изобретателя этого устройства, американского инженера Винсента Бендикса.
* Бердан (берданка) — винтовка, названная по имени изобретателя, полковника Хайрема Бердана (1824—1893).
* Берилл — драгоценный камень, название которого, попавшее в европейские языки через древнегреческий из Индии, восходит к городу Белур в Южной Индии.[1]
* Бефстроганов — от фр. Bœuf Stroganoff, «говядина по-строгановски»; названо в честь графа А. Г. Строганова (1795—1891).
* Бешамель — соус, изобретение или усовершенствование которого приписывается Луи де Бешамелю (Louis de Béchameil, 1630—1703), французскому откупщику.
* Бикини — женский купальный костюм из двух частей, названный по ассоциации с атоллом Бикини, на котором за 4 дня до первой демонстрации купальника (вызвавшей фурор) произошли испытания ядерного оружия.
* Битюг — сильная ломовая лошадь крупной породы, от реки Битюг, левого притока Дона, в окрестности которой была выведена эта порода лошадей.[1]
* Блютус — спецификация беспроводных сетей, наименование происходит от переведённого на английский язык прозвища короля Харальда I Синезубого (Harald Blåtand).
* Боливар — модная в 1830-х годах широкополая шляпа, названная по имени Симона Боливара (1783—1830), освободителя Латинской Америки от испанского владычества.
* Бодони — шрифт, начертание которого было разработано итальянским типографом Джамбаттистой Бодони (1740—1813).
* Бойкот — форма политической или экономической борьбы, прекращение отношений с кем-либо в знак протеста против чего-либо, названная по фамилии английского управляющего Чарльза Бойкотта, в отношении которого в 1880 году ирландскими арендаторами была применена эта мера.
* Браунинг — пистолет производства одноимённой компании, от имени её основателя, бельгийского оружейника Джона Мозеса Браунинга (1855—1926).
* Брегет — марка часов, в честь часовщика Абрахам-Луи Бреге (Breguet).
* Бурбон — алкогольный напиток, в честь королевской династии Бурбонов.
* Вальтер — пистолет, названный по фамилии основателя оружейной фирмы Walther.
* Вагранка — небольшая чугуноплавильная печь, названа по уральской реке Вагран, притоку Сосьвы, протекающему в районе Богословских заводов, где была построена первая вагранка.
* Ватман — белая плотная бумага, созданная в 1770-х годах английским бумажным фабрикантом Дж. Ватманом.
* Верньер — поворотная рукоятка со шкалой, предложенной французским математиком Пьером Вернье (Pierre Vernier, 1580—1637).
* Винчестер — винтовка, названная по имени основателя оружейной фирмы Винчестера.
* Водевиль — одноактная комедийная пьеса, от французского названия местности Vau de Vire (долина реки Вир) в Нижней Нормандии, известной своими сатирическими народными песнями.
* Вокзал — здание для обслуживания пассажиров, восходит к англ. Vaux Hall, от имени Джейн Вокс (Jane Vaux, Fauxe или Fawkes, по некоторым предположениям, вдовы казнённого заговорщика Гая Фокса), владелицы увеселительного загородного сада Воксхолл-Гарденз близ Лондона в XVII в.
* Вулкан — гора, извергающая расплавленную лаву и раскалённые газы; термин происходит от имени древнеримского бога огня Вулкана.
* Газ — лёгкая прозрачная ткань, название восходит к ближневосточному городу Газа.
* Галифе — вид брюк, названных в честь французского генерала Г. Галифе (1830—1909).
* Георгин — цветок, названный по имени учёного И. Г. Георги (1729—1802).
* Гетто — первоначально район Венеции.
* Гиацинт — 1) цветок; 2) драгоценный камень. От имени персонажа греческой мифологии Гиацинта (или Гиакинфа), из крови которого вырос цветок.[1]
* Гигиена — наука о сохранении здоровья, от имени древнегреческой богини здоровья Гигиеи, дочери Асклепия.
* Гильотина — орудие смертной казни, названо по имени изобретателя Гильотена.
* Гобелен — ковёр, распространённое название произошло от «Мануфактуры Гобеленов».
* Грог — алкогольный напиток, от прозвища Old Grog («Старина Грог») британского адмирала Вернона (Edward Vernon; 1684—1757), по скупости дававшего матросам ром, разбавленный водой.
* Даунтаун — деловой центр города, изначально район Нью-Йорка.
* Дерби — скачки, названы по имени аристократического семейства Дерби.
* Деррик — мачтовый кран, по названию машиностроительной фирмы.
* Джакузи — гидромассажная ванна, названа по фамилии братьев Jacuzzi, изобретателей, основавших одноимённую фирму.
* Джерси — трикотажная ткань, названная по острову Джерси, где этот материал был впервые выпущен.
* Дизель — двигатель внутреннего сгорания, в честь его изобретателя Рудольфа Дизеля.
* Дрезина — тележка на железнодорожном ходу, названа по имени Карла Дреза.
* Доберман — порода служебных собак, выведена Луисом Доберманном.
* Донегаль (донегол) — плотная шерстяная ткань, первоначально ткавшаяся вручную крестьянами графства Донегол в Северо-Западной Ирландии.
* Донжуан (от имён Дон Жуан, Дон Хуан, Дон Джованни, Дон Гуан) — распутник, развратник, персонаж многих художественных произведений. Например, Владимир Высоцкий сыграл роль Дон Гуана в художественном фильме «Маленькие трагедии» (1979).
* Дьюар — специальный сосуд (термос), изобретённый сэром Джеймсом Дьюаром.
* Жаккард — гладкая безворсовая ткань сложного плетения, названная по имени изобретателя программируемого ткацкого станка Ж. М. Жаккара (Joseph Marie Jacquard, 1752—1834).
* Зенобия (Зеновия) — род цветковых растений, листопадный кустарник. Назван по имени Зенобии (Зеновии) Септимии, царицы Пальмиры.
* Иммельман — фигура высшего пилотажа была названа в честь немецкого лётчика Макса Иммельмана.
* Июль — месяц, назван в честь Юлия Цезаря.
* Июнь — месяц, назван в честь римской богини Юноны.
* Каллиопа — паровой орга́н; назван по имени Каллиопы, древнегреческой музы эпической поэзии, науки и философии.
* Кардан — механизм, назван в честь изобретателя Кардано.
* Кардиган — вязаный жакет на пуговицах, без воротника и лацканов; назван в честь британского генерала Джеймса Томаса Брюднелла (лорда Кардигана).
* Картер — основная корпусная деталь машин или механизмов, от фамилии английского инженера Картера (J. Harrison Carter).
* Кашемир — ткань (а также сырьё для её производства — пух коз), от названия индийского штата Кашмир.
* Кингстон — клапан в подводной части судна, открывающий доступ забортной воде; назван по имени изобретателя, английского инженера Джона Кингстона (1786—1847).
* Кларк — число, выражающие среднее содержание химического элемента в земной коре, в честь учёного Франка Кларка.
* Кольт — огнестрельное оружие, производимое на заводах Сэмюэла Кольта.
* Кондом — контрацептив, изобретённый Чарльзом Кондомом.
* Коньяк — алкогольный напиток, традиционно называется как и одноимённый город во Франции.
* Кретон — плотная жёсткая хлопчатобумажная ткань с орнаментом. Название происходит, по разным версиям, от имени ткача Поля Кретона (Paul Creton), либо от местности Кортон (Courtonne), либо от городка или деревни Кретон (Creton) в регионе Буи-сюр-Дамвиль (Buis-sur-Damville) в Нормандии, на севере Франции.
* Ксерокс — обычное наименование копировального аппарата, по названию фирмы Xerox, первой начавшей выпускать эти устройства.
* Кульман — чертёжный инструмент, названный по имени изобретателя, Карла Кульмана.
* Лагуна — озеро вокруг Венеции.
* Ловелас — развратник, персонаж эпистолярного романа Сэмюэла Ричардсона «Кларисса».
* Макинтош — прорезиненный плащ или мужское летнее пальто. Названо по фамилии шотландского химика Чарльза Макинтоша
* Мансарда — жилое помещение чердачного типа, названо по имени архитектора Франсуа Мансара.
* Мартен — печь для выплавки стали мартеновским способом, от имени французского металлурга Пьера Мартена.
* Маузер — оружейная компания, выпускающая известные пистолеты, от имён Петера Маузера и Вильгельма Маузера.
* Махаон — бабочка, названа в 1758 г. шведским натуралистом Карлом Линнеем в честь полулегендарного врача-хирурга Махаона, сына Асклепия и Эпионы, принимавшего участие в походе греков на Трою во время Троянской войны.
* Меандр — характерная форма русла от названия реки на юго-западе Турции.
* Мегера — сварливая женщина, название происходит от Мегеры (др.-греч. Μέγαιρα, «завистливая»), персонажа древнегреческой мифологии, одной из трёх Эриний.
* Мерседес — марка автомобилей, а также автомобильный концерн, назван в честь Еллинек Мерседес.
* Меценат — покровитель науки и искусств, название произошло от имени Гая Цильния Мецената.
* Монгольфьер — аэростат, изобретённый пионерами воздухоплавания братьями Монгольфье (фр. Montgolfier) — Жозефом-Мишелем (1740—1810) и Жаком-Этьенном (1745—1799).
* Монпансье — леденцы, от имени герцогини Монпасье.
* Муслин — вид мелко-тканой хлопчатобумажной ткани, завезённой в Европу с Ближнего Востока в XVII веке. Название от Mussolo — итальянского названия города Мосул в Ираке.
* Наган — револьвер, разработанный бельгийскими оружейниками братьями Эмилем и Леоном Наганами.
* Нанка — дешёвая хлопчатобумажная ткань, названная по китайскому городу Нанкин.
* Наполеон — первоначально треугольное пирожное (в виде знаменитой треуголки императора Наполеона I), получившее своё название в 1912, во время широкого празднования 100-летия изгнания французов из России.
* Нарцисс — растение, названо по имени героя древнегреческого мифа Нарцисса. См. также нарциссизм.
* Николь — оптический прибор для поляризации света, изобретённый Уильямом Николем в 1828 г.
* Нониус — вид шкалы, изобретённой португальским астрономом Педро Нунишем (1502—1578).
* Оливье — салат, изобретённый кулинаром Люсьеном Оливье, державшим в Москве в начале 60-х годов XIX века ресторан парижской кухни «Эрмитаж».
* Османы (оттоманы) — основное население Османской империи, этноним произошёл от имени её основателя Османа I.
* Панама:
** Панама — шляпа, название произошло от центральноамериканской страны Панама;
** Панама — хлопчатобумажная или шерстяная гладкокрашеная ткань, название произошло от центральноамериканской страны Панама;
** «Панама» — крупное мошенничество, название происходит от аферы и финансового скандала, происшедшего при строительстве Панамского канала.
* Панацея — всеисцеляющее лекарство, от древнегреческой богини Панакеи (Панацеи), дочери Асклепия.
* Панталоны — от имени Панталоне, персонажа итальянской комедии дель арте.
* Папарацци — фоторепортёры, снимающие сцены из личной жизни звёзд шоу-бизнеса и других знаменитостей без их ведома и согласия. Названы по имени фотографа Папараццо, героя кинофильма Федерико Феллини «Сладкая жизнь»,
* Патефон — механическое устройство для проигрывания граммофонных пластинок, от названия фирмы-производителя: Пате.
* Пралине — десерт, назван по имени изобретателя, маршала Франции Сезара дю Плесси-Пралина Шуазёля (César du Plessis-Praslin de Choiseul, 1598—1675)
* Пульман — комфортабельный пассажирский железнодорожный вагон, выпускался фирмой «Пульман», основанной Джорджем Пулльманом.
* Радиола — конструктивно объединённые радиоприёмник и проигрыватель грампластинок, существовал товарный знак «Радиола», существует растение с таким же названием.
* Реглан — вид верхней одежды, изобретён для лорда Реглана (Раглана), потерявшего руку в битве при Ватерлоо.
* Рекамье — короткая кушетка с высоким изголовьем. Названа по имени Жюли Рекамье. На картине «Портрет мадам Рекамье» она возлежит на кушетке именно такого типа.
* Сарпинка — лёгкая хлопчатобумажная ткань полотняного переплетения, с полосатым или клетчатым рисунком. Название — от реки Сарпа, протекавшей в Саратовской губернии, месте основного производства этой ткани.
* Сатин — хлопчатобумажная ткань. Названа по старинному арабскому названию Зайтун китайской гавани Цюаньчжоу, откуда вывозилась эта ткань.
* Секвойя — дерево, названное в честь индейского вождя Секвойи.
* Сиена — коричневый пигмент, названный по итальянскому городу Сиена.
* Сизаль — натуральное грубое волокно для изготовления канатов и т. п., от названия мексиканского порта Сисаль.
* Силуэт — разновидность графической техники, получил название от имени министра Франции Этьена Силуетта.
* Сомма — остатки вулкана, образующие вал вокруг молодого вулкана, первоначально — Везувия.
* Стетсон — ковбойская шляпа, была изобретена Джоном Стетсоном.
* Страз — имитация драгоценного камня, сделанная из свинцового стекла, от фамилии изобретателя, эльзасского ювелира Георга Штрасса (Georges Frédéric Strass, 1701—1773).
* Сукре — денежная единица Эквадора, названа в честь Антонио Хосе Сукре.
* Сэндвич — бутерброд, назван по имени Джона Монтегю, 4-го графа Сэндвичского.
* Твид — ткань, от названия шотландской реки Туид (Твид).
* Тифон — прибор для подачи громких звуковых сигналов, от торговой марки Kockums Tyfon фирмы Kockum Sonics, выпускавшей такие приборы в 1930-х годах. Название восходит к Тифону (др.-греч. Τυφών, Τυφωεύς), хтоническому чудовищу древнегреческой мифологии, великану с необычайно громким голосом.
* Тюль — лёгкая прозрачная сетчатая гладкая или узорчатая ткань (а также занавески из такой ткани), от города Тюль (Tulle), департамент Коррез, Франция.
* Фиакр — наёмный городской конный экипаж, от названия гостиницы «Hôtel de saint Fiacre» («Отель святого Фиакра») в Париже; Фиакр (Fiacre, ирл. Fiáchra, лат. Fiacrius) — ирландский святой VII в.
* Фломастер — инструмент для письма и рисования, слово происходит от торговой марки Flo-Master.
* Френч — вид курток военного покроя, названных по имени британского фельдмаршала Джона Дентона Френча.
* Хулиган — по фамилии английской семьи Халиган, члены которой отличались буйным нравом.
* Цеппелин — дирижабли жёсткой системы, в честь изобретателя графа Цеппелина.
* Цицеро — типографский шрифт размером 12 пунктов, получил название от имени Цицерона, первое печатное издание книги которого, вышедшее в 1465 году, было набрано таким кеглем.
* Чичероне — гид, проводник, дающий объяснения туристам при осмотре достопримечательностей, от итал. cicerone, из лат. Cicero — Цицерон.
* Шалон — лёгкая шерстяная ткань с диагональными полосами. Название связано с первоначальным местом производства — городом Шалон-сюр-Марн во Франции.
* Шевиот — ткань из шерсти чевиотских овец (en:Cheviot Hills, горы на севере Англии).
* Шрапнель — вид артиллерийского снаряда, назван в честь изобретателя Генри Шрэпнела.
* Эскулап — шуточное название врача, от латинского варианта имени древнегреческого бога медицины Асклепия.

!!! Единицы измерения

Все единицы измерения, названные в честь учёных, пишутся со строчной буквы, однако их сокращения начинаются с заглавной (например, А и ампер, К и кельвин, Вт и ватт, и т. д.).

* Ампер — единица измерения силы тока, в честь Андре Ампера.
* Ангстрем — единица измерения расстояний, в честь Андерса Ангстрема.
* Беккерель — единица измерения активности радиоактивного источника, в честь Антуана Беккереля.
* Бел — безразмерная единица измерения отношения (разности уровней) некоторых величин, в честь Александра Белла.
* Био́ — редко применяемая единица силы тока в системах СГСМ и СГСБ (сантиметр-грамм-секунда-био), названная в честь французского учёного Жана-Батиста Био.
* Бод — единица измерения символьной скорости, в честь Жана Бодо.
* Букингем — единица измерения квадрупольного момента, в честь английского химика Дэвида Букингема.
* Ватт — единица измерения мощности, в честь Джеймса Уатта (Ватта).
* Вебер — единица измерения магнитного потока, в честь Вильгельма Эдуарда Вебера.
* Вольт — единица измерения электрического напряжения, в честь Алессандро Вольта.
* Гал (или галилео) — единица измерения ускорения, в честь Галилео Галилея.
* Гаусс — единица измерения магнитной индукции, в честь Карла Фридриха Гаусса.
* Генри — единица измерения индуктивности, в честь Джозефа Генри.
* Герц — единица частоты периодических процессов, в честь Генриха Герца.
* Гильберт — единица измерения магнитодвижущей силы, в честь Уильяма Гильберта.
* Грэй — единица поглощённой дозы ионизирующего излучения, в честь Льюиса Грея.
* Дальтон — единица массы, применяемая для масс молекул, атомов, атомных ядер и элементарных частиц, в честь Джона Дальтона.
* Дарси — единица проницаемости пористых сред, в честь Анри Дарси.
* Дебай — единица измерения электрического дипольного момента молекул, в честь Петера Дебая.
* Джоуль — единица измерения работы, энергии и количества теплоты, в честь Джеймса Джоуля.
* Зиверт — единица измерения эффективной и эквивалентной доз ионизирующего излучения, в честь Рольфа Зиверта.
* Кельвин — единица измерения температуры, в честь Уильяма Томсона (лорда Кельвина).
* Кулон — единица измерения электрического заряда, в честь Шарля Кулона.
* Кюри — единица измерения активности радиоактивного источника, в честь Пьера Кюри и Марии Склодовской-Кюри.
* Ламберт — единица измерения яркости поверхности, в честь Иоганна Генриха Ламберта.
* Лэнгли — единица поверхностной плотности энергии, в честь Самуэля Лэнгли.
* Максвелл — единица измерения магнитного потока, в честь Джеймса Клерка Максвелла.
* Махе — единица объёмной альфа-активности радиоактивного источника, в честь австрийского физика Генриха Махе.
* Мах — отношение скорости течения в данной точке газового потока к местной скорости распространения звука в движущейся среде, в честь Эрнста Маха.
* Непер — единица измерения отношения двух величин, в честь Джона Непера.
* Ньютон — единица измерения силы, в честь Исаака Ньютона.
* Ом — единица измерения электрического сопротивления, в честь Георга Симона Ома.
* Паскаль — единица измерения давления, в честь Блеза Паскаля.
* Пуаз — единица динамической вязкости, в честь Ж. Л. М. Пуазёйля.
* Резерфорд — единица измерения активности радиоактивного источника, в честь Эрнеста Резерфорда.
* Рентген — единица экспозиционной дозы радиоактивного облучения, в честь Конрада Рентгена.
* Ридберг — величина, входящая в уравнение для уровней энергии и спектральных линий, в честь Йоханнеса Ридберга.
* Рэлей — единица измерения поверхностной яркости, Роберта Стратта, 4-го барона Рэлея.
* Савар — единица интервала высоты и частотного интервала, в честь французского физика Феликса Савара.
* Сименс — единица измерения электрической проводимости, в честь Вернера фон Сименса.
* Стокс — единица кинематической вязкости, в честь Дж. Г. Стокса.
* Сэбин — единица поглощения энергии звука, в честь американского физика У. К. Уоллеса.
* Тесла — единица измерения индукции магнитного поля, в честь Николы Тесла.
* Торр — единица измерения давления, в честь Эванджелиста Торричелли.
* Фарад — единица измерения электрической ёмкости, в честь Майкла Фарадея.
* Фарадей — единица измерения электрического заряда, в честь Майкла Фарадея.
* Ферми — единица измерения длины и расстояния, в честь Энрико Ферми.
* Франклин — название единицы измерения электрического заряда, в честь Бенджамина Франклина.
* Эйнштейн — единица измерения, используемая в фотохимии, в честь Альберта Эйнштейна.
* Эрланг — единица интенсивности нагрузки (чаще всего телефонной нагрузки), в честь Агнера Крарупа Эрланга.
* Эрстед — единица измерения напряжённости магнитного поля, в честь Ганса Христиана Эрстеда.
* Этвеш — единица измерения градиента гравитационного поля, в честь Лоранда Этвёша.
* Янский — единица измерения спектральной плотности потока излучения, в честь Карла Янского.