!! Старорусские обзывательства

Много-много новых старых слов, которые разнообразят ваши ругательства и сделают их более изощренными.

Русский язык чертовски богат, в том числе на ругань, обзывательства и обидные эпитеты. А мы в своей речи используем лишь малую часть предоставляемых нам возможностей. Ну кого удивишь «дураком», «скотиной» или «бестолочью». А можно назвать человека (только того, кто действительно этого заслуживает, конечно) так, что он точно поймет, что его только что обозвали, но вот кем именно не совсем ясно. Оторопь, привлечение внимания, заинтересованность, а затем и уважение с восхищением вам гарантированы, если вы будете употреблять в своей речи те богатства, которые подарил нам старинный русский язык и разнообразные диалекты.

В этом материале AdMe.ru представляет вам несколько десятков таких слов, поделенных на категории для пущего удобства. Теперь вы будете знать, что если вас назвали «захухрей», то с утра вам просто надо было лучше причесаться.

!!! Обзывательства про ум

* Баламошка — полоумный, дурачок
* Божевольный — худоумный, дурной
* Божедурье — дурак от природы
* Королобый — крепкоголовый, тупой, глупый
* Лободырный — недоумок
* Межеумок — человек очень среднего ума
* Мордофиля — дурак, да еще и чванливый
* Негораздок — недалекий

!!! Обзывательства про внешность

* Пентюх — пузатый человек с выдающейся кормой вдобавок
* Безпелюха, тюрюхайло — неряха
* Брыдлый — гадкий, вонючий
* Затетёха — дородная женщина
* Загузастка — круглая, толстая женщина с большой попой
* Ерпыль — малорослый
* Захухря — нечёса, неряха, растрепа
* Шпынь голова — человек с безобразием на голове
* Фуфлыга — невзрачный маленький мужичок

!!! Обзывательства про характер

* Маракуша — противный человек
* Хобяка, Михрютка, Сиволап — неуклюжий, неловкий
* Свербигузка — девка-непоседа, у нее свербит в одном месте (гузка — это попа). Она же Визгопряха
* Ащеул — пересмешник, зубоскал
* Ветрогонка — вздорная баба
* Баляба — рохля, разиня
* Белебеня, Лябзя — пустоплет
* Бобыня, Буня — надутый, чванливый
* Бредкий — говорливый, болтливый (от слова «бред», как вы понимаете)
* Колотовка — драчливая и сварливая баба. Она же Куёлда
* Гузыня или Рюма — плакса, рёва
* Пыня — гордая, надутая, недоступная женщина
* Пятигуз — ненадежный человек, дословно можно перевести как «пятижоп»
* Расщеколда — болтливая баба
* Попрешница — женщина, которую хлебом не корми, дай поспорить
* Суемудр — ложно премудрый
* Костеря, кропот, скапыжник — брюзга, ворчун
* Шинора — проныра
* Чужеяд — паразит, нахлебник

!!! Обзывательства про поведение

* Волочайка, Гульня, Ёнда, Безсоромна — все это великолепие эпитетов посвящено распутным женщинам
* Бзыря, Блудяшка, Буслай — бешеный повеса, гуляка
* Валандай, Колоброд, Мухоблуд — бездельник, лодырь
* Глазопялка — любопытный
* Печная ездова — лентяйка
* Трупёрда — неповоротливая баба
* Тьмонеистовый — активный невежа
* Ерохвост — задира, спорщик
* Ёра — озорная, бойкая на язык женщина
* Киселяй, колупай — вялый, медлительный человек
* Шлында — бродяга, тунеядец
* Потатуй — подхалим
* Насупа — угрюмый, хмурый

!!! И еще хорошие синонимы к привычным нам словам

* Вымесок — выродок
* Выпороток — недоносок
* Сдёргоумка — полудурок
* Вяжихвостка — сплетница
* Лоха — дура
* Остолбень, дуботолк, несмысел, околотень — дурак
* Шаврик — кусок дерьма
* Окаём — отморозок
* Курощуп — бабник
* Чёрт верёвочный — псих
* Облуд, обдувало — врун
* Огуряла, охальник — безобразник и хулиган
* Сняголов — сорвиголова
* Пресноплюй — болтун
* Тартыга — пьяница
* Туес — бестолочь