!! Ложные друзья переводчика

Ложные друзья переводчика (калька фр. faux amis), или межъязыковые омонимы (межъязыковые паронимы) — пара слов в двух языках, похожих по написанию и/или произношению, часто с общим происхождением, но отличающихся в значении. Например, польск. miasto — город, а не место; czas — время, а не час, англ. angina — стенокардия, а не ангина, genial — добрый, а не гениальный, magazine — журнал, а не магазин; англ.  и исп.  mosquito — комар, а не москит. Ложные друзья переводчика могут приводить к неправильному пониманию и переводу текста. Часть из них образовалась из-за того, что после заимствования значение слова в одном из языков изменилось, в других случаях заимствования вообще не было, а слова происходят из общего корня в каком-то древнем языке, но имеют разные значения; иногда созвучие чисто случайно. Термин «ложные друзья» был введен М. Кёсслером и Ж. Дероккиньи в 1928 году в книге «Les faux amis ou Les pièges du vocabulaire anglais».

Частным случаем ложных друзей переводчика являются псевдоинтернационализмы — межъязыковые омонимы, ассоциирующиеся (по своей графической и/или фонетической форме) со словами интернациональной лексики и вызывающие разного рода трудности при переводе: полное или высказывания, нарушение лексической сочетаемости или стилистического согласования слов в высказывании.

В противоположность ложным друзьям переводчика существуют также слова, которые в двух данных языках имеют одинаковое значение и сходное звучание. Подобные «друзья переводчика» называются лексическими когнатами.

(:childlist:)

!!! Причины появления

!!!! Совпадение

Например, англ. mist — туман, нем. Mist — навоз. Это совпадение привело к конфузу при экспорте в Германию компьютерной игры Myst и дезодоранта Mist Stick.

Не менее яркий пример — слово Gift, которое по-английски означает подарок или одарённость, а по-немецки — яд, отрава. Соответственно gifted на английском это одарённый, а по-немецки giftig означает ядовитый.

!!!! Независимое развитие языков

На праславянском языке слово «вонять» означало «пахнуть». В русском его смысл сдвинулся до «плохо пахнуть», в то время как в западнославянских языках (например, в чешском — духи по-чешски — voňavka) оно не несёт отрицательного смысла. Исходное значение в русском языке осталось в слове «благовоние» (приятный запах), преимущественно используемом для описания запаха в церкви и других местах преклонения.

Так же украинское слово «вродливий» (произносится «вродлы́вый») означает «красивый», а созвучное ему русское «уродливый» имеет противоположное значение. Того же генезиса польское слова «uroda» переводится на русский язык как «красота».

Аналогично, candy — «сладкая вата» в британском варианте английского языка и «конфета» — в американском. Оба этих слова происходят от to candy — «засахаривать».

Изредка случается, что заимствованное слово обретает в новом языке собственную жизнь. Так, очень много подобных слов в японском языке: они пришли из английского языка и во многих случаях поменяли свое значение. Например, слово Rough (ラフ) (означает «грубый», «жесткий») в современном японском означает «стиль носить повседневную одежду». Слово Service (サービス) стало означать «скидку», словосочетание Salary man (サラリーマン) — «работника компании», «офисного работника». Такие японские слова обычно называют Васэй-эйго.

!!!! Изменение значения слова при заимствовании

Слова обычно заимствуются для того, чтобы дать название некоторому новому понятию. Часто для этого заимствуются слова в своём неосновном значении.[источник не указан 498 дней]

Английское old-timer (старик, ветеран) было позаимствовано многими языками в суженном значении — старинный автомобиль. Слово «док» (dock) было позаимствовано для того, чтобы назвать помещение для ремонта кораблей (Dry dock), хотя в английском языке это слово — пристань вообще.

!!!!! Параллельное заимствование

Языки А и Б могут заимствовать слова из языка В в разных значениях. В русско-английских «ложных друзьях» общий предок чаще всего латынь.

* Русское «ангина» происходит от лат. angina tonsillitis («удушение от воспаления миндалин»), в то время как английское angina (стенокардия) — от лат. angina pectoris («удушение грудное»)
* В большинстве европейских языков слово préservatif, preservativo и т. д. означает «барьерный метод мужской контрацепции» (в этом значении слово вошло и в русский), но в английском preservative — «консервант».

!!! Список распространённых ошибок

Здесь представлены пары межъязыковых омонимов, перевод которых нередко приводит к ошибкам.

!!!!! Первый тип.

Омонимы с абсолютно разным набором лексических значений. Их можно спутать лишь по причине созвучия (типичные омонимы), например булка (болг.) и булка (рус.), Angel (нем.) и ангел (рус.) (см. примеры).

!!!!! Второй тип.

Омонимы, некоторые лексические значения которых совпадают полностью либо частично за счет наличия общих признаков, позволяющих отнести эти слова с данными значениями к одной сфере употребления.

Именно последний случай связан с наибольшим количеством ошибок при переводе. Например, английское слово «aggressive» имеет не только значение «агрессивный», но и «настойчивый, энергичный». Совпадение первого лексического значения слова «aggressive» с лексическим значением русского «агрессивный» может привести к тому, что, например, при переводе словосочетания «aggressive salesman» второе значение английского слова, которого нет у русского, проигнорируется и словосочетание будет переведено как «агрессивный продавец» вместо корректного «настойчивый продавец».

Другой пример. Слово «electric» в английском языке означает «электрический», тогда как по звучанию оно совпадает с русским «электрик». Оба значения имеют непосредственное отношение к электричеству, и знание этого факта при одновременном незнании правил словообразования может явиться причиной смешения смыслов во время перевода.

!!!! В английском языке

* academic — учёный, работающий в университетской системе, а не академик (academician) — звание учёного в научной иерархии и ученый, обладающий этим званием;
* accurate — точный, а не аккуратный в значении «опрятный» (tidy); В русском языке осталось в виде наречия «аккурат» (аккурат в 5 часов)
* airline — авиакомпания, а не авиалиния;
* air-port (пишется через дефис) — иллюминатор (в борту корабля);
* aggressive — энергичный, инициативный, а не только агрессивный (например, aggressive salesman);
* alley — переулок, а не только аллея; blind alley — тупик;
* ammunition — боеприпасы, а не амуниция;
* anecdote — интересный или поучительный случай из жизни известных людей, а не анекдот в современном значении слова (joke);
* angina — также стенокардия, а не только ангина(tonsillitis);
* argument — также спор, а не только аргумент
* artist — художник, живописец, а не только артист
* audience — это как правило аудитория — публика в зале наблюдающая за происходящим на сцене, а не только аудиенция
* ball: слова baseball, football, basketball обозначают не только названия игр, но и мяч, которым в них играют («He caught the football», «Do you have a baseball?», «football-shaped» и т. п.);
* banner — знамя; девиз; крупный заголовок (не только баннер);
* barrack — также казарма, а не только барак;
* benzene — это не бензин, а бензол; в то же время gasoline — это бензин, а не газойль;
* brilliant — блестящий, а не бриллиантовый;
* cabin — каюта корабля, салон самолёта, кабинка (в туалете и т. д.), будка, лачуга (кабина одноместного самолёта/гоночного автомобиля — cockpit, кабина тяжёлого (пассажирского) самолёта — (crew) compartment или flight deck, кабина грузовика/автобуса/поезда — cab, кабина лифта — car);
* cabinet — шкаф (а также Кабинет Министров), но не кабинет (комната);
* cable — трос (не только кабель);
* carton — небольшая коробка (а не картон — cardboard);
* cartoon — мультипликационный фильм (а не картон — cardboard);
* Caucasian — представитель Европейской расы, «белый»; а не только выходец с Кавказа[4];
* chef — шеф-повар (а не шеф — chief, boss, patron);
* class — также тип (а не только класс; Ohio-class ship — корабль типа «Огайо» (пример не совсем верен, так как в этом случае корабль как, раз «класса „Огайо“»));
* closet — шкаф, чулан, кладовка, а не только клозет;
* collector — коллекционер, а не только коллектор;
* comfort — утешение, поддержка, а не только комфорт
* compositor — наборщик, а не композитор (composer, musician);
* conductor — дирижёр, гид, проводник (электропроводный материал), а также ж.-д. проводник, погонщик, интендант, а не только кондуктор[6] (в русском языке имеет значение «проводник» и «часть электрической машины»)
* control — управлять (не только контролировать или проверять — verify, check);
* convoy — свита, эскорт, а не только конвой[7];
* crest — гребень, грива или шлем (а не крест — cross);
* debris — останки, осколки, а не дебри;
* decade — 10 лет (а не Декада − 10 дней);
* design — в технике не внешний вид, как в русском языке, а конструкция, устройство (например, об автомобиле или корабле); также план, замысел
* designer — инженер-разработчик, а не дизайнер − человек, занимающийся графическим, ландшафтным, автомобильным и тому подобным дизайном (обычно stylist);
* director — глава, режиссёр, дирижёр, духовный отец (не только директор, руководитель компании)[8];
* dock — причал, пристань (не только док — помещение для ремонта кораблей);
* Dutchman — голландец, а не датчанин — Dane; также Dutch — голландский (амер.англ. немецкий), а не датский — Danish, dutch — старуха;
* elеctric — электрический, а не электрик (electrician)
* engineer — моторист, машинист (не только инженер);
* episode 1 — часть 1, выпуск 1, серия 1 (не только эпизод 1);
* erection — также возведение, стройка, а не только эрекция;
* examine — врачебный или технический осмотр, допрос (а не экзамен — test, exam);
* faggot — (оскорбительное) гомосексуалист, «педик» (а не фагот — bassoon)
* figure — чеpтёж, иллюстрация; цифра; число (не только фигура);
* fiction — художественная литература, беллетристика, а не только фикция;
* football (в американском английском) — американский футбол, а не футбол (soccer);
* fruit — плод (в самом широком смысле), не только фрукт;
* gallant — храбрый (не только галантный);
* gas (в американском английском), gasoline — бензиновое топливо, а не только газ;
* gay — лицо с нетрадиционной сексуальной ориентацией вообще — не только гей, но и лесбиянка
* general — основной, общий, обычный (не только генеральный и генерал);
* genial — добрый (а не гениальный — genius);
* glands (ед. ч. gland) — железы в целом, а не именно гланды (tonsils)
* idea — понятие, мысль (не только идея);
* instruments — измерительные приборы; музыкальные инструменты; финансовые инструменты (financial instruments) (а не инструменты — tools);
* intelligent — умный, интеллектуальный (а не интеллигентный);
* interest (финансы) — не интерес (устар.), а проценты, или доход по вкладу и т. п.
* interview — собеседование (интервью только в случае, если оно проводится журналистом);
* lift — поднятие, подъём, поднимать, повышать (а не только лифт — elevator (амер, кан.), lift(брит). также означает украсть, стянуть, стащить);
* liquor — крепкое спиртное, а не ликёр — Liqueur;
* lord — владыка, Господь, а не только лорд;
* lunatic — сумасшедший (не лунатик — sleep-walker);
* machinist — слесарь (не только машинист)
* magazine — журнал (не научный) и магазин для патронов, но не магазин с товарами — shop, store;
* master — хозяин (а не только мастер);
* matron — старшая медсестра, кастелянша (не только матрона);
* mayor — мэр города (а не майор — major);
* morale — боевой дух (а не мораль — morality);
* more — сравн. ст. от much — более (а не море — sea);
* mosquito — комар (а не москит — sandfly или phlebotomine);
* most — превосх. ст. от much — более всего, большинство или наибольший (а не мост — bridge);
* mystery — тайна, и лишь в редких случаях мистерия;
* nationality — не только национальность, национальная принадлежность, но и гражданство, принадлежность к стране происхождения (почти всегда вызывает недопонимание между выходцами из бывшего Советского Союза и Запада. Для избежания недопонимания — примерный ответ: Where are you from? I am an ethnic Russian from Uzbekistan, Ты откуда? Я этнический русский из Узбекистана);
* net — сеть (а не нет — no/not);
* novel — роман (чаще, чем новелла); это слово очень часто переводят неправильно;
* officer — чиновник, должностное лицо, сотрудник (например Консульства, особенно в предложении «at the interview was present not only the Secretary of the Consulate but one of the other officers too» — «на собеседовании присутствовал не только Секретарь Консульства но и еще один из сотрудников»), а не только офицер;
* original — настоящий, подлинный, изначальный (не только оригинальный);
* paragraph — не только параграф, но и абзац;
* partisan — партиец; протазан (копьё с широким плоским наконечником), а не только партизан;
* party — также и вечеринка (не только партия);
* pathetic — убогий, жалкий (а не только патетический или пафосный);
* patron — спонсор, уважаемый клиент (а не патрон), не только в значении босса ;
* periodic acid — иодная кислота, а не «периодическая»;
* phenomenon — явление (не только феномен — редкое или уникальное явление);
* phonograph — граммофон, патефон, проигрыватель (электрофон), а не только фонограф;
* piston — поршень, а не пистон;
* plaster — замазка, штукатурка (а не пластырь — bandaid);
* plastic — прилагательное пластичный, пластический (не только пластик как материал);
* principal — директор школы, колледжа, ректор ВУЗа, а также ведущий актёр или солист в труппе (а не принципиальный — principle);
* poem — Стихотворение, а не только поэма.
* Reactive - ответный а не реактивный (jet/rocket propelled) Например тип снаряда который в русской языке называют активно-реактивным иногда ошибочно переводя на английский как «active-reactive» то есть «активно — ответный» вместо «Rocket Assisted».
* realize — чётко представлять, осознавать (а не только реализовывать);
* regular — нормальный, обычный, стандартный (а не только регулярный; regular water — простая (питьевая) вода, а не регулярная);
* resin — смола, канифоль, камедь (а не резина — rubber);
* restaurant — в американском английском — любое предприятие общепита вообще (даже закусочная McDonald’s), а не только ресторан;
* revision — исправление, переработка, а не только ревизия;
* romance — рыцарский стихотворный роман (не только романс);
* satin — атлас, атласное платье (а не сатин — sateen или chintz);
* scholar изучающий что-то, а не только школьник;
* sever — разрывать, отрывать (а не север — north);
* sex — половая принадлежность, а не только секс;
* shop — мастерская, цех, ателье, студия (а не только магазин (брит.));
* shower — проливной дождь, а так же показывающий (от слова show), (а не только душ);
* silicon — кремний (а не силикон — silicone). См. Силиконовая долина — распространённое в русском языке название Кремниевой Долины.
* speaker — не только спикер, но также и динамик;
* speculation — предположение, умозрительное построение, рискованное начинание (без негативного оттенка, который есть в русском языке);
* student — учащийся вообще, а не только студент ;
* sympathetic — сочувствующий, сочувственный (а не только «симпатичный»);
* sympathy — чаще всего сочувствие, а не симпатия в значении «влечение, внутреннее расположение к кому-, чему-л.»[16]; легко запоминается, если обратиться к этимологии слова: sym- — со-, вместе + pathos — чувство; отсюда: слова с идентичным смыслом sympathetic, sympathize и пр.;
* technique — способ, методика, метод; также техника в смысле «набор приёмов» близко к русскому слову «технология», (техника в прямом смысле обозначается словом technics);
* tort — гражданское правонарушение, а не торт;
* trailer — прицеп, жилой вагончик, трейлер (кинематограф) (не только трейлер — прицеп-платформа для перевозки крупных штучных грузов[7]);
* trophy — в спорте «кубок» или «приз» (а не только «трофей» — War booty, каким он является в текстах о войне);
* tunic — также китель, гимнастерка, а не только туника;
* universal — всемирный, а не только универсальный;
* utilize — также использовать (а не только утилизировать);
* velvet — бархат (а не вельвет — corduroy);
* virtual — действительный, фактический, а не только виртуальный.

!!!! В белорусском языке
\
* адказ — ответ (отказ — адмова);
* бракаваць — недоставать;
* блага — плохо, скверно;
* бялізна — бельё;
* бяспечны — безопасный;
* выго́да — удобство, уют;
* вялікі — большой;
* вяселле — свадьба;
* гной — навоз;
* годны [годнасць] — достойный [достоинство] (годный — прыдатны);
* грошы — деньги;
* дараваць — простить;
* другі (другога) — второй (второго) (другой — іншы);
* дыван — ковёр;
* забіваць — убивать;
* інтэрнат — общежитие;
* карысць — польза;
* качка — утка;
* кій — палка;
* крэсла — стул (кресло — фатэль);
* кубак — чашка(кубок — келіх);
* ледзь — чуть, едва;
* лік — число, счет (лик — абра́з);
* ліст — письмо, лист дерева (лист бумаги — аркуш паперы);
* лістапад — ноябрь;
* люты — февраль;
* мех — мешок (мех — футра);
* мястэчка — малый город;
* нядзеля — воскресенье (неделя — тыдзень);
* падстава — основание, повод;
* паліца — полка (палица — булава);
* пакой — комната;
* паверх — этаж;
* плот — забор;
* парушыць — нарушить;
* правіць — чинить (править — кіраваць);
* прозвішча — фамилия (прозвище — мянушка);
* прыклад — пример;
* прышчэпка — прививка;
* пытаць — спрашивать (пытать — катаваць);
* раса — ряса (а не только раса);
* рэч — вещь;
* сваяк — (любой) родственник;
* сказ — предложение;
* скарб — сокровище;
* склад — слог, состав;
* склон — падеж (склон — схіл);
* свет — мир (свет — святло);
* справа — дело;
* спраўны — хороший, добрый, качественный, а не только исправный;
* старонка — страница;
* стрэльба — ружье (стрельба — стральба);
* трус — кролик, а тру́сы, соответственно, кролики;
* тэрмін — срок;
* убіраць — впитывать, вбирать, включать (убирать — прыбіраць);
* узор — образец;
* урадлівы — урожайный;
* час — время (час — гадзі́на);
* шалёны — бешеный;
* штучны — искусственный;
* чыніць — делать, совершать;
* хаваць — прятать;
* хвоя — сосна (хвоя — ігліца).

!!!! В болгарском языке

* банка — банк (а не «банка» — буркан)
* бор — сосна (а не «бор» — борова гора)
* булка — невеста (а не «булка» — пи́тка);
* вестник — газета (а не «вестник» — вестител)
* диня — арбуз (а не «дыня» — пъпеш)
* дума — слово (а не «дума» — мисъл)
* думам уст. — говорить (а не «думать» — мисля)
* слово — выступление (а не «слово» — дума)
* гора — лес (а не «гора» — планина́);
* горе — вверх (а не «горе» — скърб, мъка, тъга)
* горен — вверхный (а не «горный» — планински)
* живот — жизнь (а не «живот» — корем).
* закуска — завтрак (а не «закуска» — мезе)
* конец — нитка (а не «конец» — край)
* коса — волосы (а не «коса» — плитка, но значение коса как с.-х. орудие совпадает)
* крушка — маленькая груша, электрическая лампочка (а не «кружка» — чаша, канче)
* кал — грязь (а не «кал» — изпражнения, екскременти)
* лайка — ромашка (также и одноимённая порода собак, но не все болгары её знают);
* лифт — подъёмник в горах (а не «лифт» — асансьо́р);
* майка — мама (а не «майка» — по́тник);
* папа — папа римский (а не «папа» — баща);
* неделя — воскресенье (а не «неделя» — седмица)
* олово — свинец (а не «олово» — кала́й);
* право — прямо (а не «право» — дя́сно, но тоже и система законов или свобода пользоваться чем-л);
* пари — деньги, пар мн.ч. (а не «пари» — бас, облог);
* пара — пар, монета в зависимости от ударения (а не «пара» — чифт);
* риза — рубашка, сорочка (а не «риза» — филон (одеяние); метална украса на икона)
* стая — комната (а не «стая» — глу́тница);
* стол — стул (а не «стол» — ма́са);
* маса — стол, масса (а не только «масса» — маса);
* точилка — скалка (а не «точилка» — острилка)
* училище — школа (а не «училище» — професионален колеж);
* школник — курсант школы запасных офицеров (а не «школьник» — ученик);
* чин — парта (а не только ранг);
* щека — лыжная или бильярдная палка (а не «щека» — бу́за);
* ягода — клубника (в болгарском нет подобного собирательного слова, ягоды считаются фруктами — плодове);
* орех — грецкий орех (в болгарском собирательное слово «орехи» — ядки);
* пушка — ружье (а не «пушка» — оръдие, топ);
* кафе — кофе (а не «кафе» — кафе, кафене, сладкарница);
* масло — это только сливочное масло (а не «подосолнечное масло» — олио);
* друг — другой (а не «друг» — приятел);
* мир — отсутствие войны (а не «мир» — свят);
* лют — острый для вкуса, ожесточенный (а не «лют» — неуморен);
* жаба — лягушка (а не «жаба» — ангина);
* велик — только великий (а не большой «велик» — голям);
* партия — только политическия партия или партия шаха (а не «партия» — партида);
* печен — жареный, бывалый (а не «печень» — черен дроб);
* град — город (но и «град» — град, градушка);
* яд — злость (а не «яд» — отрова);
* врат — шея (а не «врать» — лъжа);
* баба — старуха (а не «баба» — жена);
* бабки — старушки (а не «бабки» — пари);
* бабичка — старушка (а не «бабочка» — пеперуда);
* сирене — брынза (а не «сирень» — люляк);
* Петя — только женское имя производное от «Петрана» (а не «Петя» — Пешо);
* Саша, Сашка — только женское имя производное от «Александра» (а не «Саша» — Сашо);
* кисело мляко — йогурт (а не «кислое молоко» — прокиснало мляко);
* грозен — некрасивый (а не «грозный» — страшен);
* под — пол (остальные значения совпадают);
* грижа — забота (а не «грыжа» — херния);
* лъжа/и — ложь (а не «лыжа/и» — ска/и);
* лижа — облизывать (а не «лыжа/и» — ска/и);
* коли — машины, автомобили (а не «коли» — ако);
* вълна — волна, но и шерсть в зависимости от ударения;
* красен — уст. красивый (а не «красный» — червен);
* зелен — зеленый (а не «зелень» — зеленчуци);
* след — за, после (а не «след» — следа);
* чест — частый (а не только честь);
* мишка — мышь (а не «мишка(медведь)» — мечка);
* комар — азартная игра (а не только комар);
* моторист — мотоциклист (а не «моторист» — механик, двигателист);
* геран — колодец (а не «герань» — здравец);
* реже — форма глагола резать (а не «реже» — рядко);
* лежа в затвора — сидеть в тюрьме (а иначе «лежа» — лежать и «седя» — сидеть);
* взимам изпит — сдавать екзамен (болгарские студенты в России говорили: «сдадох си изпита», вместо «взех си изпита», «имам пара» в смысле у меня «учебная пара», что вообще будет непонятно болгарину, он скорее всего поймет: «у меня есть пар» или «у меня монета»)
* гуляя — гулять, устраивать пир (а не просто прохаживаться — «разхождам се»)
* могила — холм, небольшое возвышение (а не место захоронения умершего — «гроб»)
* клюка — сплетня (а не палка, на которую опираются при ходьбе -«патерица»)
* щука (произносится «штука» — рыба щука (а не «штука» — вещь — «нещо»"

!!!! В испанском языке

* americano — гражданин любой страны Северной, Южной или Центральной Америки, (а не только гражданин США — norteamericano, estadounidense, а иногда и презрительное gringo).
* arena — песок.
* colectivo (Лат. Ам.) — автобус, а не коллектив.
* compromiso — не только компромисс, а (гораздо чаще) обязательство, помолвка.
* débil — слабый, (а не дебил).
* faro — не только фара автомобиля, а (гораздо чаще) — маяк.
* jornal — дневной заработок, а не журнал (revista).
* leche — молоко
* macho — самец (применительно к людям — «болван»), а не мачо (machote).
* marasmo — стагнация, упадок, депрессия (а в узко медицинской терминологии — алиментарный маразм), но не маразм в общеупотребительном смысле — demencia.
* papa (Лат. Ам.) — картошка (а не папа — papá)
* parada — остановка автобуса или трамвая, (а не парад — desfile).
* pena — боль, мучение, наказание, (а не пена — espuma; ср. пеня).
* sombrero — шляпа (любая шляпа, не только сомбреро).
* tumba — могила.

!!!! В литовском языке

* blogas — плохой (а не блог — tinklaraštis)
* net — даже (а не «нет» — ne, nėra)
* prastas — дрянной, никудышний (а не простой — paprastas)
* suka — крутит, поворачивает (а не сука — kalė)
* koldunai - пельмени - а не колдуны

!!!! В монгольском языке

* бал — мёд (а не бал — бүжигт үндэшлэг).
* гам — бережливость, осторожность (а не гам — шуугиан).
* год — кожа, снятая с лап животного (а не год — жил).
* том — большой (а не том — боть).
* улаан — красный, а не улан.
* шар — жёлтый (а не шар — бөмбөг).

!!!! В немецком языке

* Anekdote — исторический случай (а не анекдот — der Witz).
* Angel — удочка или петля (а не ангел — der Engel).
* Dom — собор (а не дом — das Haus).
* Elf — одиннадцать (числительное), (а не только эльф).
* Familie — семья (а не фамилия — der Name, der Nachname).
* Glas — стакан, рюмка или просто стекло (а не глаз — das Auge).
* Knigge — правила хорошего тона (а не книга — das Buch).
* Krawatte — галстук (а не кровать — das Bett).
* Krug — кувшин или кружка (а не круг — der Kreis).
* reklamieren — предъявлять претензии, жалобы (а не рекламировать — werben, Reklame machen).
* Rock — юбка (а не рок-музыка — die Rockmusik).
* rot — красный (цвет) (а не рот — der Mund).
* Schar — сборище людей, толпа (а не шар — die Kugel).
* Schienen — рельсы, а не шины (автомобильные шины — Autoreifen).
* Schlange — змея, очередь (а не шланг — der Schlauch).
* Schüler — ученик (а не шулер — der Falschspieler, der Betrüger).
* Tank — только в смысле ёмкости для жидкости (а не боевая машина — der Panzer).
* Tort — неприятность, обида, несправедливость (а не торт — die Torte).
* Wetter — погода (а не ветер — der Wind)
* Zentner — пятьдесят килограмм (а не сто — Doppelzentner).

!!!! В норвежском языке

* konkurs — банкрот, а не конкурс (konkurranse)

!!!! В польском языке

* angielski — английский, а не «ангельский»
* bark — плечи, а не «корабль-барк»
* bielizna — бельё, а не «белизна»
* blada — бледная, а не «падшая женщина»
* błoto — грязь, а не «болото»
* brązowy — (читается как «бронзовы») коричневый
* buraczki — редис, а не маленькие бураки (свёкла)
* but — ботинок, а не «бут», «бутовый камень»
* chełm — шлем, а не «холм»
* ciasto (читается как «часто») — печенье, а не «часто»
* czas — время, а не «час»
* czasami — иногда, а не «часами»
* czaszka (читается как «чашка») — череп, а не «чашка»
* czubek — макушка, а не «чубчик»
* czychać — подстерегать, а не «чихать»
* czynność — действие, а не «чинность»
* ćma — ночная бабочка, а не «тьма»
* dowolny — любой, а не «довольный»
* drań — мерзавец, а не «дрянь»
* dworzec — вокзал, а не «дворец»
* dywan — ковёр, а не «диван»
* furtka — калитка, а не «форточка»
* garnitur — костюм, а не «гарнитур»
* głaz — крупный камень, валун а не «глаз»
* gracz — игрок, а не «грач»
* grób — могила, а не «гроб»
* grzywna — штраф, а не «гривна»
* guzik — пуговица, а не «гузик» (маленький гуз, шишка)
* gwałt — преступное насилие, а не «гвалт»
* izba — комната, а не «изба»
* jutro — завтра, а не «утро»
* kaczka — утка, а не «качка»
* karnet — сезонный проездной билет, абонемент, а не «корнет»
* kawior — икра́, а не «ковёр»
* kij — вообще любая палка, а не только «кий»
* kokarda — бант, а не «кокарда»
* kolce - колючки, а не "кольца"
* komórka — клетка (биологическая), ячейка (партийная, электронная), а не «коморка»
* korki — пробки (в том числе винные, автомобильные), а не «корки»
* koryto — русло, а не «корыто»
* kozaki — зимние полусапожки, а не «казаки»
* krawat — мужской галстук, а не «кровать»
* kreda — мел, а не «кредо»
* krzesło — стул, а не «кресло»
* kubek — кружка, а не «кубок»
* kurek — водопроводный кран, а не «курок»
* kwas — кислота, а не «квас»
* list — письмо, а не «лист»
* listopad — ноябрь, а не «листопад»
* łodyga — стебель, а не «лодыжка»
* łóżko — кровать, а не «ложка»
* łyżwy (читается как «лыжвы») — коньки, а не лыжи
* magazyn — склад, журнал, а не магазин
* magazynek — обойма с патронами, а не «магазинчик»
* malarz — художник, а не «маляр»
* miasto — город, а не «место»
* miłość — любовь, а не «милость»
* mord — убийство, а не «морда»
* motyl — любая бабочка вообще, а не «мотыль» или «мотылёк»
* muł — ил, а не «мул»
* nagły — внезапный, а не «наглый»
* napływ — прилив (в том числе морской), а не «наплыв»
* narty — лыжи, а не «нарты»
* nawóz — удобрение вообще, а не только «навоз»
* oddany — самоотверженный, жертвенный, а не «отданный»
* oddychać — дышать, а не «отдыхать»
* odpływ — отлив (в том числе морской), а не «отплыв»
* ogon — хвост, а не «огонь»
* okulary — очки, а не «окуляры»
* ołów - свинец, а не "олово"
* owad — насекомое вообще, не «овод»
* owoc — фрукт, а не «овощ»
* pach — подмышка, а не «пах»
* palić — курить, а не «палить»
* piegi — веснушки, а не «пегий»
* pień — целый ствол дерева, а не «пень»
* piłka — мяч, а не «пилка»
* piłka nożna — футбол, а не «ножная пилка»
* pisarz — писатель, а не «писарь»
* piwnica — подвал, а не «пивная»
* plecy — спина, а не «плечи»
* pluton — взвод, а не «планета Плутон»
* płot — забор, а не «плот»
* pogrzeb — похороны, а не «погреб»
* potas - калий, а не "поташ"
* poziomka — земляника, а не «позёмка»
* pozorny — кажущийся, а не «позорный»
* przymus — принуждение, сквиз (в бридже), а не «примус»
* puszka — консервная банка, а не «пушка»
* rano — утро, а не «рано»
* rozkosz — наслаждение, а не «роскошь»
* ryk — мычание, а не «рык»
* ser biały — творог, а не «белый сыр»
* siatkówka — волейбол, а не «сетчатка»
* sklep — магазин, а не «склеп»
* smukła — стройная, а не «смуглая»
* smutny — грустный, а не «смутный»
* spisek — заговор (к примеру политический), а не «список»
* spotykać się — встречаться, а не «спотыкаться»
* stół (читается как «стул») — стол, а не «стул»
* sufit — потолок, а не «софит»
* sutki — соски́, а не «сутки»
* szał — исступление, а не «шаль»
* szczyt — горная вершина (в том числе в переносном смысле как апогей), а не «щит»
* sztuczny — искусственный, а не «штучный»
* sztuka — искусство, также «пьеса», а не «штука»
* szyna — рельс, а не «шина»
* śliwki — плоды сливы, а не «сливки»
* śmietanka — сливки, а не «сметанка»
* talerz — тарелка, а не «талер»
* taras — терраса, а не имя Тарас
* tlen — кислород, а не «тлен»
* trawnik — газон, а не «лекарь-травник»
* tusz — душ, а не «тушь»
* twarz — лицо, а не «тварь»
* ubrać — одеть, а не «убрать»
* ukrop — кипящая жидкость, а не «укроп»
* uroda — красота
* wątroba — печень, а не «утроба»
* wesele — свадьба, а не «веселье»
* widmo — спектр, а не «видимо»
* woń — запах (к примеру духов, цветов и т. п.), а не «вонь»
* wzwód — эрекция, а не «взвод»
* zachwyt — восхищение, а не «захват»
* zamordowany — убитый, а не «замордованный»
* zapamiętać — запомнить, а не «запамятовать»
* zapomnieć — забыть, а не «запомнить»
* zdanie — предложение, фраза, а не «здание»
* zimny — холодный, а не «зимний»
* znaczek — почтовая марка, а не «значок»
* znamię — родинка, а не «знамя»
* żal — скорбь, а не «жаль»
* żałoba — траур, а не «жалоба»
* żelazko — утюг, а не «железка»

!!!! В сербском языке

* штука — щука, а не штука
* право — прямо, а не право
* [править]В чешском языке
* Огромный список — [19][20][21][22]
* čerstvý — свежий, а не чёрствый
* hrad — за́мок, а не «город», «град»
* město — город, а не место
* ovoce — фрукты, а не овощи (zelenina)
* pozor — осторожно, внимание, а не позор (hanba, potupa)
* potraviny — продукты, а не «отрава»
* vzor — образец, а не «взор»
* chytrý — умный, а не «хитрый»

!!!! В украинском языке

* біли́зна — бельё, а не белизна — білизна́.
* безпе́чний — безопасный, а не беспечный — безтурбо́тний.
* весі́лля — свадьба, а не веселье — весе́лощі.
* великий (произносится «вэлыкый») — большой, а не только великий.
* вік — возраст, но не столетие — століття.
* власний — собственный, а не властный — владний.
* вродли́вий (произносится «вродлывый» от слова врода — красота) — красивый, а не уродливый — потво́рний (произносится «потворный»).
* га́дка — мысль, а не гадка́.
* гадати — полагать (считать), а не гадать — ворожить.
* гаразд — хорошо, ладно (в знач. сказ.), должным образом, как следует, а не горазд — зді́бний (до чогось).
* гарбу́з — тыква, а не арбуз — кавун.
* година — час, а не год — рiк.
* горіх — орех, а не горох — горох.
* горо́д — огород, а не город — мiсто.
* господа́рство — хозяйство (не господство, не государство). Господар — хозяин.
* гро́ші — деньги, а не гроши́. Значение «очень маленькая сумма денег» сохранилось за словом в единственном числе — гріш (без гроша, гріш ціна и т. д.).
* гребля — плотина, а не гребля — веслува́ння (произносится «вэслува́ння»).
* диви́тися (произносится «дывытыся») — смотреть, а не дивиться — дивува́тися.
* дивний (произносится «дывный»)— странный, а не дивный — чудо́вий.
* дити́на (дыты́на) — ребенок, а не детина (большой человек, иронически)
* доля — судьба, а не часть — частка.
* дружина — жена, а не только дружина.
* жаба — лягушка, а не жаба — ропуха.
* жінка — женщина, а не только жена.
* зоря — звезда, а не только заря
* качка — утка, а не качка — хитави́ця (произносится «хытавыця»).
* кіт — кот, а не кит — кит (произносится «кыт»).
* кі́шка — кошка, а не кишка — кишка́ (произносится «кышка»).
* кома — запятая, а не только кома
* крава́тка — галстук, а не кроватка — лі́жко.
* кри́си — поля шляпы, а не крысы — щури́, пацюки́.
* лапки [лапкы́] — кавычки, а не лапки
* ла́яти — ругать, а не лаять — га́вкати.
* лічи́ти — считать, а не лечить — лікува́ти.
* листопа́д (произносится «лыстопад») — ноябрь, а не только листопад.
* луна — эхо, а не луна — мiсяць.
* лютий (произносится «лютый») — февраль, а не только лютый.
* мiсто — город, а не место — мíсце.
* наглий (произносится «наглый») — внезапный, а не наглый — нахабний (произносится «нахабный»).
* недiля — воскресенье, а не неделя — ти́ждень (произносится «ты́ждэнь»)).
* пара — пар, а не только пара
* паска — не блюдо из творога, а хлеб, кулич.
* печеня́ — жаркое, а не печень — печі́нка.
* пильний (произносится «пыльный») — внимательный, а не пыльный — запорошений.
* пита́ти (произносится «пытаты») — спрашивать, а не пытать — катува́ти.
* південь — юг, а не полдень — полудень
* північ — север, а не только полночь.
* прізвище — фамилия, а не прозвище — прі́звисько.
* просто — прямо, а не только просто
* рація — правота, а не только рация. Напр. мав рацію — был прав.
* ріг — угол (внешний), а не только рог
* рідкий — жидкий, а не редкий — рі́дкісний.
* родина (произносится «роды́на») — семья, а не родина — батьківщи́на.
* російський — русский, а не только российский
* росіянин — этнический русский, а не только россиянин.
* руський — древнерусский или (устар.) русинский, а не русский — російський
* свари́ти — ругать, а не сварить — звари́ти.
* сир (произносится «сыр») — творог, а не только сыр.
* сказ — бешенство, а не сказ — ро́зповідь.
* склад — состав, а не только склад
* скарб — сокровище, а не только скарб.
* термін — срок, а не только термин.
* участь — участие, а не участь — доля, тала́н.
* час — время, а не час — годи́на (произносится «годына»).
* чоловік — муж или мужчина, а не человек — люди́на (произносится «людына»).
* шар — слой, а не шар — ку́ля.

!!!! В турецком языке

* baba — отец (а не баба — karı); ударение, как и во многих турецких словах, на последнем слоге
* bardak — стакан (а не бардак — karışıklık, хотя русское слово «бардак» происходит именно от этого турецкого/тюркского слова)
* bayan — женщина, леди, мадам (а не баян — akordeon)
* durak — остановка (транспорта), отдых, пауза (а не дурак — ahmak, akılsız)
* halat — трос, канат (а не халат — gömlek (как рабочая одежда), bornoz (банный/купальный), sabahlık (дамский), ropdöşambr (мужской); последнее слово употребляется крайне редко)
* huy — характер, нрав, натура (а не х*й — yarak)
* kabak — тыква (а не кабак — meyhane)
* kerpiç — саман (строительный кирпич — tuğla); само слово saman на турецком значит солома
* kulak — ухо (а не кулак — yumruk, и не зажиточный крестьянин — refah köylü)
* manda — буйвол, мандат на управление территорией (а не манда — am)
* mama — детское питание (а не мама — anne); ударение на последнем слоге
* master — магистр (ученая степень) (а не мастер — usta)
* para — монета, деньги (а не пара — çift); ударение на последнем слоге
* saray — дворец (а не сарай — ambar, хотя русское «сарай» происходит именно от этого турецкого/тюркского слова, которое, в свою очередь, пришло туда из персидского)
* sok — «вставь» — повелительное наклонение глагола «вставлять» (а сок (напиток) будет meyve suyu)
* spor — спорт, (а не спор — tartışma)
* şapka — не только шапка, но и шляпа; также колпачок (как технический термин) и шляпка гриба (слово заимствованно из русского языка)
* tabak — тарелка (а не курительный табак — tütün)
* tuman — кальсоны (а не туман — sis, хотя русское слово «туман» происходит от турецкого/тюркского duman — дым, мгла)
* tuz — соль (а не туз — bey, as)
* yazık — жаль (а не язык — lisan или dil)