!! Программы UNIX-подобных операционных систем

Это список популярных программ, работающих в операционных системах основанных на UNIX (POSIX-совместимых). Некоторые из этих программ являются стандартными для UNIX-систем.

!!! Системный софт

!!!! Общего назначения

* dd — Преобразование и копия файлов (Disk Dump). Заполнение файла или диска данной последовательностью байтов
* dirname (или basename) — Возвращает часть пути к указанному файлу
* echo — Вывод в стандартный вывод
* env — Вывод или изменение переменных окружения (environment); запускает программу с индивидуальным окружением
* file (или stat) — Определяет тип файла
* nohup — Вызывает утилиту невосприимчивую к сигналу hang up
* sh — Bourne shell, стандартный командный процессор в операционных системах UNIX
* uptime — Выводит время от последней перезагрузки

!!!! Управление Системой

* fuser — Распознаёт процессы по файлам или сокетам
* logger — Создаёт запись в системном логе
* newgrp (или sg) — Вход(log in) в новую группу
* pathchk — Проверяет на переносимость имена файлов

!!!!!  Информация о ядре

* date (en) — Текущие дата и время (печать/установка)
* dmesg — Отображает буфер системного сообщения
* ipcrm — Удаляет очередь сообщений, установленные семафоры или id общей памяти
* ipcs — Выводит информацию о IPC средствах
* uname — Печатает различную информацию о системе.

!!!!!  Управление процессами и задачами

* anacron — Планировщик задач, см cron
* at — Планировщик однократных команд
* chroot — изменение корневой (root) директории для всех дочерних процессов
* cron — Планировщик периодического запуска команд
* crontab — Редактор скриптов crontab планировщика задач cron
* daemonic — Интерфейс к демону init-скрипта
* kill — Завершение процесса (по его PID)
* killall — Завершение процесса(ов) (по имени)
* nice — Установка приоритета процессов
* pgrep — Поиск процесса по имени, или другому атрибуту.
* pidof — GNU/Linux эквивалент pgrep или утилита, печатающая PID по имени процесса
* pkill — Посылает указанный сигнал процессам, найденным по имени или другому атрибуту.
* ps — Печать информации о текущих процессах
* renice — Изменение приоритета уже работающих процессов
* sleep — Задержка на заданное время
* time — Время выполнения команды
* top — Представляет динамический список всех запущенных процессов

!!!!!  Управление и сопровождение пользователями

* finger — Запрашивает информацию о пользователе
* id — Печать информации о настоящем/эффективном идентификаторе пользователя/группы (real/effective UIDs/GIDs)
* last — Выводит список последних входов пользователя
* lastlog — Проверяет лог последних входов
* locale — Получение информации о текущей локализации.
* localedef — Компиляция локализационной информации
* logname — Печатает login пользователя
* man — Печатает помощь по команде (самая главная команда для начинающего пользователя)
* mesg — Возможность получать сообщения от других пользователей, которые используют write
* passwd — Изменение пароля пользователя
* su — Запускает новый процесс (по умолчанию shell) от имени другого пользователя (по умолчанию root)
* sudo — Запускает программу от имени суперпользователя (root)
* users — Показывает вошедших в систему (только имена пользователей)
* w — Показывает вошедших пользователей и их текущие задачи
* whatis — Поиск по справочным страницам
* whereis — Выводит полный путь к команде и странице справочника ассоциированных с какой-либо командой
* which — Показывает полный путь исполняемой команде
* who — Список зарегистрировавшихся (logged in) пользователей
* whoami — Выводит имя текущего пользователя
* write — Сообщение другому пользователю

!!!!!  Настройка терминалов

* stty — Изменение установок терминала или печать текущих установок
* tput — Инициализация информации совместимости терминала
* tty — Печатает имя файла терминала, подключённого к стандартному вводу

!!!! Файлы и текст

* info — Интерактивная справочная система для ПО GNU.
* man — Стандартная для Unix система документации.

!!!!!  Утилиты файловой системы

* chgrp — Смена группы, владеющей файлом
* chmod — Изменение прав доступа к файлу
* chown — Смена владельца файла
* cp — Копирует файл или каталог в другое место
* df — Выдаёт информацию о свободном месте на диске
* dircmp — Сравнивает содержимое файлов двух каталогов
* du — Вычисляет место, занятое на диске
* fdupes — Поиск одинаковых файлов в пределах одной директории
* find — Поиск файла в иерархии директорий
* fsck — Проверка файловой системы
* ln — Создаёт ссылку на файл или каталог
* ls — Вывод содержимого каталога
* lsof — Выводит список открытых файлов
* mkdir — Создаёт новый каталог
* mkfifo — Создаёт именованный канал
* mount — Монтирует файловые системы
* mv — Перемещает или переименовывает файл или каталог
* pwd — Выдаёт текущий каталог
* rm — Удаляет файлы или каталоги
* rmdir — Удаляет пустой каталог
* touch — Создаёт новый файл или же, в случае его существования, изменяет его время модификации
* tree — Выводит дерево каталогов, начиная с данного
* unlink — Удаляет один указанный файл
* uucp — Копирует файлы с одного Unix-хоста на другой (Unix to Unix CoPy)
* Md5sum — вычисляет или проверяет MD5 хеш файлов (для проверки целостности файлов).

!!!!!  Архиваторы и компрессоры

* afio — Совместимый расширенный набор cpio с увеличенной функциональностью
* ar — Создаёт, модифицирует и извлекает файлы из архивов. Устарел, вместо него используется tar.
* bzip2 — Компрессор файлов с поблоковой сортировкой
* compress — Традиционный компрессор, использующий алгоритм LZW
* cpio — Копирует файл в или из cpio или tar-архива.
* gzip — Компрессор файлов gzip
* p7zip — Архиватор 7-zip для командной строки
* pax — POSIX архиватор, поддерживающий множество форматов.
* rzip — Архиватор аналогичный по возможностям gzip и bzip2, но оптимизированный для работы с большими файлами.
* tar — Лентовый архиватор (Tape ARchiver), стандартный архиватор, не осуществляет сжатие файлов, происходит лишь последовательное объединение их содержимого, либо же извлечение файлов из архива. Используется многими программами-компрессорами (gzip, bzip2 и пр.)
* uncompress — Распаковывает файлы, сжатые при помощи compress
* zcat — Конкатенация упакованных файлов с выводом содержимого архива в STDOUT

!!!!!  Перекодирование

* convmv — Утилита выполняет преобразования имён файлов из одной кодировки в другую.
* enca — Средство для автоматического определения кодировки текстового файла, с возможностью преобразования в необходимую кодировку. Хорошо работает со всеми известными русскими кодировками, поддерживает UTF-8
* iconv — выполняет преобразование кодировок переданных файлов. Поддерживает большое количество различных кодировок, в том числе UTF-8
* fillterm — Аналог эмулятора терминала в стиле screen, но перекодирующий ввод/вывод от программы к пользователю «на лету», позволяя программе работать в одной кодировке, а пользователю взаимодействовать с программой в другой.
* konwert — Надёжное, но долгое преобразование из различных кодировок
* recode — Преобразование из различных кодировок

!!!!! Текстовые процессоры

* awk — Язык поиска по образцу и обработки текстовых файлов
* banner — Создаёт ASCII art сообщения для печати больших надписей
* cat — Конкатенация файлов с выводом в STDOUT
* cksum — Печатает CRC контрольную сумму и число байтов для файла (см. также MD5)
* cmp — Утилита для побайтового сравнения файлов
* comm — Построчно сравнивает два файла, которые должны быть предварительно лексически отсортированы
* csplit — Разделяет файл на секции по некоторым определённым линиям
* cut — Вырезание нужных кусков из каждой строки файла
* diff3 — Утилита для сравнения одного файлы с двумя другими
* diff — Утилита для сравнения файлов построчно
* egrep — Расширенный обработчик шаблонов (синоним «grep -E»)
* expand — Преобразует табуляцию в пробелы
* fc — Процессы в списке истории команд
* fgrep — Простой обработчик шаблонов (синоним «grep -F»)
* fold — Складывает длинные линии по ширине устройства вывода
* grep — Печатает строки удовлетворяющие регулярному выражению (сейчас чаще используются расширенные регулярные выражения и соответственно команда egrep)
* head — Вывод начальной части файла (заглавия)
* join — Выводит линии из двух файлов содержащих общие поля
* less — Улучшенное more. Программа постраничного вывода текста
* merge — Объединяет три файла (см. также paste)
* more — Постраничный вывод информации
* most — Видоизменённое less. Построчный вывод информации на экран.
* nkf — Преобразование японских символов
* nl — Число строк в файле
* nroff — Фиксатор ширины (не машинописный) версия стандартной машинописной Unix системы
* od — Перевод файлов в различные форматы: восьмеричный, шестнадцатеричные, десятеричный, ascii
* paste — Объединяет линии файлов
* patch — Изменение файла путём применения специального файла изменений («наложения патча»)
* rev — Обращает лини файлов в противоположное направление
* sed — Потоковый текстовый редактор (Stream EDitor)
* sort — Сортировка строк файла
* split — Разделение файла на куски
* tac — Обращение названия команды cat — выводит содержимое файла в стандартный поток вывода в обратном порядке, начиная с конца
* tail — Возвращает несколько строк с конца файла
* tee — Читает из стандартного ввода, пишет в стандартный вывод и файлы
* tr — Транслирует символы
* trs — Аналог tr, но заменяющий одну последовательность символов на другую.
* tsort — Выполняет топологическую сортировку
* unexpand — Превращение пробелов в символы табуляции
* uniq — Удаляет повторяющиеся строки.
* uudecode — Декодирует бинарные файлы, что были использованы при пересылке электронной почтой
* uuencode — Кодирование бинарных файлов для пересылки по электронной почте
* wc — Считает слова, строки или байты в файле.
* wdiff — Сравнивает файлы по словам, а не по строкам.

!!!!! Текстовые редакторы

* acme — Графический текстовый редактор с интегрированной средой разработки портированный из операционной системы Plan 9 с клиент-серверной архитектурой разработанный Робом Пайком. Это приёмник sam
* ed — Традиционный построчный текстовый редактор Unix, основанный на регулярных выражениях
* ex — Текстовый редактор из BSD Unix, оригинал получился из Unix ed, позже создали экранный «visual» mode и создали vi; обычно оформлена как символическая ссылка на vi (или vim) которая запускает как построчный редактор
* Emacs — Свободно программируемый полноэкранный текстовый редактор и общее компьютерное окружение (использует встроенный elisp, простой диалект языка программирования Lisp)
* joe — Полноэкранный текстовый редактор с командами в стиле Wordstar
* jove — Полноэкранный текстовый редактор с командами в стиле Emacs
* MicroEMACS — Полноэкранный текстовый редактор с командами в стиле Emacs
* nano — клон pico
* NEdit — Основанный на Motif текстовый редактор для X Window System, напоминающий текстовый редактор из Mac или Microsoft Windows систем
* nvi — «Новый» (New) vi, не содержащий оригинального кода Unix ex/vi для релиза операционной системы 4.4BSD
* pico — Редактор сообщений для pine
* sam — Графический текстовый редактор из Plan 9
* vi — «Визуальный» экранный редактор
* VILE — vi-подобный текстовый редактор с множественными буферами, разделением экрана, Подсветкой синтаксиса и некоторыми другими дополнениями не содержащихся с обычных ex/vi («Vi like Emacs»)
* vim — Vi IMproved, клон vi, обладающий функцией подсветки синтаксиса и многими другими дополнительными возможностями;
* XEmacs — Популярная версия emacs полученная из GNU emacs

!!!!  Коммуникации, сетевой и удалённый доступ

* Apache веб-сервер
* HylaFAX — Fax сервер
* netcat
* NFS — Сетевая файловая система (Network File System)
* OpenVPN — Открытый VPN софт
* rsh, SSH, telnet — Удалённое управление
* Samba — SMB и CIFS клиенты и сервера для Unix
* Sendmail — Популярный софт по передаче электронной почты
* talk — Позволяет разговаривать с другим вошедшим(logged—in) пользователем
* uustat — Базовая Сетевые Утилиты команды информацию о статусе нескольких типов базовых сетевых операций
* uux — Удалённая команда управления UUCP

!!!!! Программы электронной почты (пользовательские агенты)

* elm — Полноэкранный почтовый агент пользователя
* mail — Оригинальный Unix клиент электронной почты
* mailx/Mail — Расширенная версия Unix клиента из BSD Unix
* Mutt — Полноэкранный клиент электронной почты
* Pine — Полноэкранный клиент электронной почты и usenet, полученный из elm

!!!!! Системы сетевых систем

* fingerd — Простой демон основанный на RFC 1196, который обеспечивает интерфейс для прграммы «finger»
* inetd — Запускает программы предоставляющие Internet-сервисы (Internet services daemon)
* xinetd — Улучшенный inetd (extended Internet services)

!!!!! Сетевые утилиты

* dig — Утилита для просмотра DNS.
* dhclient — DHCP клиент. Позволяет производить автоматическое конфигурирование сетевых интерфейсов (получения адреса и маски подсети, настройка шлюзов, информация о сервисах сети и многие другие параметры).
* ifconfig — Утилита для конфигурирования сетевых интерфейсов. Позволяет задавать адрес интерфейса, маску подсети, создавать новые и удалять существующие интерфейсы, а также производить их тонкую подстройку.
* iwconfig — Утилита для конфигурирования беспроводных сетевых интерфейсов wi-fi. Позволяет задавать тип соединения (ad-hoc, master, managed), имя сети (ESSID), канал соединения (chanel 1..11). Так же утилита iwconfig позволяет посмотреть параметры сетевого интерфейса в реальном времени.
* ping — Сетевая утилита для проверки присутствия некоторых хостов в сети
* pppd — PPP сервер. Позволяет как устанавливать исходящие соединения, так и принимать входящие.

!!!!! Мониторинг и безопасность сети

* ettercap — Инструмент для анализа сетевых протоколов
* John the Ripper — Программы для взлома паролей
* Nessus — Сканер различных уязвимостей сети с открытым кодом
* Nmap — Свободная программа для сканирования портов
* SATAN (the Security Administrator Tool for Analyzing Networks) — инструмент для тестирования и создания отчётов собираемые с хостов
* Snoop — Снифер из Solaris
* Snort — Система распознавания вторжений с открытым кодом
* tcpdump — Утилита по отладке компьютерных сетей, которая интерпретирует и отображает получаемые и передаваемые TCP/IP пакеты
* Wireshark — Анализатор протоколов или «сниффер пакетов» подобный tcpdump, но имеющий графический Front-end и некоторые параметры сортировки и фильтрации

!!!! Средства Программирования

!!!!! Скриптовые Интерпретаторы

!!!!!! Командные интерфейс (Shell)

* sh — Bourne shell, присутствует на всех Unix-like системах, написан Stephen Bourne для Version 7 Unix
* bash — Bourne Again SHell, стандартная оболочка для linux систем
* csh — C shell. Написал Bill Joy для BSD-систем
* tcsh — TENEX C shell, стандартная оболочка для BSD-систем
* ksh — Korn shell, стандартная оболочка для многих проприетарных Unix-систем, написал David Korn
* psh — Perl shell, оболочка по мотивам Perl
* rc — Изначально оболочка написана для Plan 9
* zsh — Z shell

!!!!!! Интерпретаторы (Non-Shell)

* awk — Стандартная для Unix программа сканирования по образцу, текстовый процессор
* Perl — Кроссплатформенный интерпретируемый язык программирования высокого уровня, с объектно-ориентированной моделью
* php — Скриптовый язык созданный специально для генерации html кода
* Python — Интерпретируемый интерактивный язык программирования высокого уровня
* Ruby — Интерпретируемый объектно-ориентированный язык программирования высокого уровня
* Lua — Легковесный интерпретируемый язык программирования
* Tcl — Интерпретируемый язык программирования

!!!!! Компиляторы и Утилиты программирования

Классическое UNIX окружение включает базовый широкий набор необходимых инструментов программирования, но в XXI веке это классическое окружение всё больше урезается, так как Unix-like операционные системы распространяются различными производителями. Что-то в значительной степени видоизменяется, модернизируется и усложняются, утилиты и окружение претерпевают изменения и убираются некоторые изжившие себя утилиты. Наиболее близкие команды к прошлым Unix реализациям:

* admin — Администрирование файлов SCCS
* c99 — Стандартный C компилятор, требуемый стандартом IEEE 1003.1-2001 («POSIX.1»)
* cc — Компилятор C
* cfront — Один из компиляторов C++
* ctags — Генерирует тэги файла определяет положенгие объекта в исходном коде
* dbx — (System V и BSD) символический дебагер
* distcc — Инструмент для сборки программ, используя несколько машин
* f77 — Компилятор Фортран 77
* gcc — Коллекция компиляторов GNU (GNU Compliler Collection)
* gdb — GNU символический дебагер
* ktrace — (BSD) прослеживания процессов ядра
* ld — Линкер программ
* lex — Лексический сканер генератор
* ltrace — (Linux) Трасер вызовов динамических библиотек в адресном пространстве наблюдаемого процесса
* m4 — Макроязыковый процессор
* make — Утилита для автоматической компоновки исходных текстов
* nm — Список символов из объектного файла
* rmdel — Удаляет разность из SCCS файлов
* strace (Linux) или truss (Solaris) — Аналогично ktrace
* strip — Убирает символы из объктных файлов
* yacc — LALR синтакситеский анализатор

!!!!! Скриптовые утилиты

* basename — Возвращает последнюю часть (имя файла или директории) из полного пути к ним
* batch — Запускает задания
* break — Выход из цикла
* continue — Пропустить текущую итерацию цикла. Применяется в скриптах
* exit — Завершение работы скрипта
* expr — Вычисляет заданное выражение
* false — Возвращает всегда ложь
* hash — Команда запоминает путь к исполняемым файлам
* return — Возвращение результата
* strings — Печатает строки печатаемых символов найденых в файле
* shift — Сдвиг, используется в сценариях.
* test — Проверка условия
* times
* true — Возвращает всегда правду
* unset
* wait
* xargs — Формирует список в одну строку взятый из стандартного ввода

!!!! Пользовательский интерфейс

* X11 — Клиент-серверная система графического интерфейса пользователя

!!!!!  Рабочие Столы/Графический Интерфейс Пользователя

* Aqua — Графический пользовательский интерфейс Apple для их ОС Mac OS X, базирующейся на Darwin BSD
* Blackbox — и его варианты (включая Fluxbox и Waimea)
* CDE — Common Desktop Environment, в основном используется в собственнических операционных системах UNIX
* Enlightenment
* FVWM и его разновидность Fvwm95, изменённая так, чтобы имитировать поведение Windows 95
* GNOME (GNU Network Object Model Environment) — Рабочее окружение для X11
* IceWM — ICE Window Manager
* KDE (K Desktop Environment) — Рабочее окружение для X11
* Openbox
* Quartz Compositor
* Window Maker
* WMI — Усовершенствованый Window Manager (Window Manager Improved)
* Xfce
* Sawfish — Оконный менеджер, работающий на LISP.

!!!! Компьютерная Безопасность

!!!!! Антивирусный софт

* ClamAV — Сканер вирусов, в основном применяется для проверки почты

!!!!! Криптография

* Enigmail (англ.) — Графический интерфейс к программе GnuPG для программ типа SeaMonkey и Mozilla Thunderbird
* GnuPG — GNU Privacy Guard, полноценная замена PGP (обеспечивает шифрование файлов и электронной почты, а также использование цифровых подписей), распространяемая по лицензии GNU GPL
* mcrypt —
* openssl — Криптографическая библиотека для поддержки SSL (Secure Sockets Layer) в различных приложениях
* pinepgp — Фильтры которые включают в pine использование шифрования/дешифрования электронной почты

!!!! Программы управления пакетами

* apt — Front-end для dpkg или rpm
* aptitude — Интеллектуальная система управления пакетами Debian
* debconf — Настройка системы пакетов Debian
* dpkg — Менеджер пакетов для Debian GNU/Linux
* drakconf — Утилита frontend управления пакетами в Mandriva Linux
* emerge — Frontend для portage
* pacman — Менеджер пакетов используемый преимущественно в Arch Linux
* portage — Менеджер пакетов Gentoo Linux
* rpm — Оригинальный менеджер пакетов для Red Hat Linux, также используется некоторыми дистрибутивами включая Mandriva Linux
* urpmi — Front-end для rpm, используемый Mandriva Linux
* YaST — Система управления пакетами используемая преимущественно в SuSE
* yum — Front-end для rpm используемый в Fedora

!!!! OS X/Darwin специфические программы

* fink — Менеджер пакетов (The Fink)

!!! Прикладной софт

!!!! Офис

* AbiWord
* Gnumeric
* Koffice
* OpenOffice.org

!!!! Мультимедиа

* Amarok — Аудио jakebox
* Ardour — Цифровая аудио рабочая станция по обработке многопоточного звука и для его редактирования
* Audacity — Запись и редактирование звука
* Baudline — Аудиозапись, анализ и проигрывание
* blender — Графический пакет для 3D моделирования
* GIMP — Пакет для обработки растровых изображений
* GStreamer — Расширяемое мультимедиа окружение
* ImageMagick — Набор утилит для пакетного преобразования изображений
* Inkscape — Векторный графический редактор
* mpg123 — Консольный MP3-плеер
* mpg321 — Свободный вариант проигрывателя mpg123
* MPlayer — Видеопроигрыватель
* Rhythmbox — Аудио jakebox подобный Apple iTunes
* Rosegarden — Мощный цифровая рабочая станция с аудио
* SoX — Утилита по перекодированию звука
* Synfig — векторный пакет 2D анимации
* Totem — Медиапроигрыватель
* transcode — Гибкий инструмент командной строики для перекодирования видео и звука в различные форматы
* VLC media player — Видеопроигрыватель
* xine — Мультимедийный проигрыватель
* xmms — Классический Winamp-подобный проигрыватель
* Krita — пакет для работы с растровыми изображениями с поддержкой планшетов

!!!! Веб Браузеры

* Dillo — Экспериментальный легковесный браузер
* ELinks — «Enhanced links» — улучшенная версия links
* Epiphany — Легковесный браузер для среды GNOME
* Galeon — веб-браузер для среды GNOME.
* Konqueror — Многофункциональная программа (в частности — веб-браузер, ftp-клиент, файловый менеджер) для среды KDE
* links — Веб-браузер с текстовым интерфейсом
* lynx — Классический веб-браузер с текстовым интерфейсом. Существует версия с поддержкой SSL
* Mozilla — Графический кроссплатформенный браузер. Также включает в себя почтовый клиент, IRC-клиент и средства Web-разработки.
* Mozilla Application Suite — Графическйи кросплатформенный браузер и клиент электронной почты
* Mozilla Firefox — Расширяемый с помощью плагинов кроссплатформенный графический веб-браузер, «облегчённая» версия браузера Mozilla
* Mozilla Thunderbird — Расширяемый с помощью плагинов почтовый клиент.
* Opera — Веб-браузер, почтовый клиент и IRC-клиент (проприетарное ПО)
* Seamonkey — Графический кроссплатформенный браузер. Появился после того, как основным направлением разработки в семействе браузеров Mozilla стал Firefox. Имеет традиционный вид и состав ПО: включает в себя почтовый клиент, IRC-клиент и средства Web-разработки.
* w3m — Консольный браузер

!!!! Менеджеры закачки

* axel — Менеджер закачки файлов с текстовым интерфейсом и с возможностью многопоточного закачивания + поиском FTP-зеркал.
* curl — Утилита командной строки для передачи файлов с синтаксисом URL
* prozilla — Консольный менеджер закачки файлов, функционально похожий на axel.
* vtun — Виртуальный тоннель TCP/IP
* wget — Текстовой, не-интерактивный менеджер закачки, поддерживает протоколы HTTP, HTTPS, FTP, может работать через http-proxy.
* yafc — FTP клиент с поддержкой SSH2 (sftp)
* zssh — Программа для передачи файлов использующая SSH

!!!! Издательские

* Groff — Традиционная машинописаная система
* LaTeX — Популярный набор скриптов для Tex
* lp — Печать файлов
* Passepartout — Издательская программа рабочего стола
* pr — Конвертирование текстовых файлов для печати
* printf — Форматирование и печать данных
* Scribus — Издательская программа рабочего стола
* TeX — Высокоуровневый макроязык системы печати
* teTeX — Популярный набор скриптов для TeX
* troff — Оригинальная и стандартная система печати Unix

!!!! Базы данных

* DB2
* Firebird
* MySQL
* Oracle
* PostgreSQL
* Progress
* SQLite
* Sybase
* Tora клиент баз данных

!!!! Математический и научный софт

* dx — OpenDX (Система визуализации данных, IBM’s Open Visualization Data Explorer)
* gerris
* Maxima — Открытая система компьютерной алгебры, написана на языке Lisp.
* octave — Компьютерный язык обработки чисел (максимально совместимый с Matlab)
* R — Язык расчёта статистики
* scilab — Аналог MATLAB
* units — Программа конвертирования единиц измерения

!!!! Утилиты рабочего стола

* bc — Калькулятор, работающий из командного процессора
* cal — Календарь из командного процессора
* dc — Калькулятор
* fortune — Печатает случайную фразу