!! Злодеи

* Аид	Геркулес	Пытался свергнуть Зевса и сделать Геркулеса смертным.
* Билл Сайкс	Оливер и компания	Хладнокровный и опасный человек, жестокий бандит из так называемой преступной «элиты» Нью-Йорка.
* Гастон	Красавица и Чудовище	Главный антагонист мультфильма. Хотел жениться на Белль и убить Чудовище.
* Губернатор Рэтклифф	Покахонтас	Очень алчный человек. Хотел завладеть землями краснокожих и стать королём.
* Джафар	Аладдин	Главный антагонист мультфильма и визирь султана Аграбы. Пытался добиться руки Жасмин и стать султаном.
* Доктор Фасилье	Принцесса и лягушка	Хитрый мошенник. Мастер магии Вуду.
* Злая королева	Белоснежка и семь гномов	Мачеха Белоснежки, пыталась убить падчерицу.
* Изма	Похождения императора	Бывшая советница Куско и его семьи. Пыталась убить наследника за своё увольнение и стать императрицей, но случайно превратила его в ламу.
* Капитан Крюк	Питер Пэн	Заклятый враг Питера Пэна, жаждет мести за то, что он лишил его руки.
* Леди Тремейн	Золушка	Мачеха Золушки. Злая, хитрая женщина средних лет, всячески ущемляла Золушку, пыталась выдать своих дочерей замуж за принца.
* Мадам Медуза	Спасатели	Злобная и хитрая женщина, похитившая Пенни из приюта.
* Мадам Мим	Меч в камне	Чёрная ведьма и заклятый враг Мерлина. Умеет использовать свои магические силы для превращений.
* Малефисента	Спящая красавица	Была оскорблена королём и королевой, пыталась погубить принцессу Аврору.
* Матушка Готель	Рапунцель: Запутанная история	Главная антагонистка мультфильма. Украла Рапунцель и растила ради её волос, чтобы сохранить молодость.
* Персиваль Маклич	Спасатели в Австралии	Жестокий браконьер. Мечтал поймать легендарную золотую орлицу, последней из своего рода.
* Пит	Мультфильмы о Микки Маусе	Грубый хулиган, докучающий Микки и его друзьям.
* Принц Джон	Робин Гуд	Пытался занять трон Англии и убить Робина Гуда, очень жадный правитель
* Профессор Рэтиган	Великий мышиный сыщик	Самый главный злодей. Крыса, но хочет, чтобы его называли мышью. Хозяин кошки, которая ест не угодивших ему.
* Рогатый Король	Чёрный котёл	демоноподобное существо,Хотел завладеть Чёрным котлом.
* Серый Волк	Три поросёнка	Пытался съесть поросят.
* Сид Филлипс	История игрушек	Всячески издевался над игрушками.
* Стервелла Де Виль	Сто один далматинец	Злая женщина, пыталась убить далматинцев ради их меха.
* Стромболи	Пиноккио	Владелец кукольного театра. Заставлял Пиноккио выступать на сцене, чтобы заработать на нём деньги.
* Си и Ам	Леди и Бродяга	Сиамские кошки. Коварны, всячески пытались дурить и запутать Леди.
* Урсула	Русалочка	Злобная морская ведьма. Превратила Ариэль в человека, но лишила голоса и с помощью магии пыталась помешать ей в отношениях с принцем. Главной её целью был трезубец Тритона, с помощью которого она хотела стать владычицей океана.
* Фролло	Горбун из Нотр-Дама	Хозяин Квазимодо, пытался влюбить в себя, а после убить Эсмеральду.
* Хоппер	Приключения Флика	Саранча. Коварный, умный, жестокий, испытывал презрение к муравьям, впоследствии пытался убить Флика.
* Шань-Ю	Мулан	Предводитель армии гуннов, напавших на Китай.
* Шерхан	Книга джунглей	Тигр. Ненавидит людей, пытался убить Маугли.
* Шрам	Король Лев	Брат Муфасы и дядя Симбы. Убил родного брата и занял его место в прайде, изгнал Симбу.
* Червонная Королева	Алиса в Стране чудес	Показана как сосредоточие ярости и гнева.
* Эдгар Бальтазар	Коты-аристократы	Главный антагонист, дворецкий мадам Аделаиды. Пытался избавиться от кошек, чтобы те не получили статуса наследников состояния.