!! Эльфийский

Годхуар: Эльфийский 
Язык поэтов и магов. Используется для общения с животными, составления заклинаний. 

(:childlist:)

!!! Краткий словарь 

!!!! Живые существа: 

Животное - celva 
Медведь - morco 
Лиса - rusco 
Волк - narmo 
Заяц - lapatte 
 Олень - arasse 
Барс (снежный кот) – lossemeoi 
Лошадь – rocco 
Кот – meoi 
Собака - huo 
Собака гончая - ronya 
Собака охотничья - huan 
Птица - aiwe, filit (маленькая птичка) 
Ястреб - fion 
Орёл - soron 
Ворона - corco 
Бабочка - wilvarin 
 Человек – atan 
Эльф – elda 
Полуэльф - perelda 
Гном – norno 

!!!! Команды и приказы: 

стоять - nara 
лежать - caita 
бежать - yura 
атакуй - nalanta 
спать - lora 
сидеть - hara 
ешь - mata 
охраняй(следи) - tira 
иди – lelya 
слушай - lasta 
смотри – tira 
говори - queta 

!!!! Пища: 

Еда (приготовленная) - apsa 
Ягода - piucca 
Вишня - valpio 
Рыба - lingwe 
Хлеб - massa 
Фрукт - yave 
Апельсин - culuma 
Эльфийское вино - limpe 
Вода - nen 

!!!! Общение: 

Приветствие – Aiya! 
Как твое имя? – Man na esselya? 
Мое имя есть... – Essenya na .... 
Прощание - namarie 