!! Словарь мадовских терминов

* Ад - Место, где игроки проводят заслуженный отпуск.
* Аплодисменты - Эхо прозвучавшей пошлости.
* Аукцион - Добровольная передача вещей одними игроками другим с параллельным засвечиванием их на весь мад.
* АФК - Слово из трех букв. Обычно сами игроки посылают себя туда сами.
* Аффект - показывает изменения, произошедшие с телом и мозгом игрока.
* Бан - Период времени, когда игроки могут отдохнуть от противных морд богов.
* Банк - Здание или сооружение, куда игроки несут свои честно заработанные миллионы.
* Баг - Радующий и печалящий момент. Абсолютно непредсказуем и не прогнозируем. Обычно радует игроков и печалит богов.
* Безбожие - Основная из великих религий.
* Бог - Высшее проявление безответственности и безнаказанности.
* Будущее - Тот период времени, когда дела наши процветают, друзья и подруги нам верны и счастье нам обеспеченно.
* Вайп - Армагеддон виртуального мира.
* Вера - Безоговорочное принятие того, что люди незнающие рассказывают о вещах небывалых.
* Виселица - Подмостки, где разыгрывается мистерия, главный герой которой отправляется на небо. В маде виселица замечательна главным образом числом игроков, счастливо избегающих ее :Е
* Восхищение - Вежливая форма признания чего-либо сходства с нами самими.
* Вурдалак - Демон, имеющий предосудительную привычку пожирать мертвецов. В 1640 году падре Секки видел вурдалака на кладбище и обратил его в бегство крестным знамением. По его описанию, тот был наделен множеством голов и необычайным комплектом конечностей, и падре видел его более чем в одном месте сразу. Сей добродетельный человек шел тогда с обеда, и он пояснил, что, не будь столь "утомлен трапезой", то поймал бы демона, чем бы это ему не грозило. В самом начале 14-го века одного вурдалака застукали в усыпальнице собора, и все жители столпились вокруг здания. Двадцать вооруженных мужчин во главе со священником, несущим распятие, вошли внутрь и схватили вурдалака, который, помышляя спастись, пустился на обман и принял обличие хорошо известного горожанина, но был, несмотря на это, повешен, вздернут на дыбе и четвертован под всеобщую чудовищную вакханалию. Горожанин же, в чьем образе предстал демон, был так потрясен этим происшествием, что никогда больше не показывался в этом городе и судьба его осталась загадкой.
* Группа - Некое сообщество игроков, объединенных мечтой о горах золота и стуфа.
* Глюк - Веселящий и огорчающий момент. Обычно веселит богов и огорчает игроков.
* Год - игровой период, состоящий из кучи разочарований.
* ДТ - Извечная забава богов. Ничто так не может порадовать бога, как появление игрока в этом месте.
* Деградация - Одна из стадий нравственной и социальной эволюции от обычного игрока к Имплементору.
* Деньги - Побочный продукт мобов.
* Доска - Мусорное ведро для мыслей и сообщений.
* Достижение - Кончина стремления и рождение неприязни.
* Знакомый - Человек, которого мы знаем достаточно хорошо, чтобы занимать у него деньги, но недостаточно хорошо, чтобы давать ему взаймы.
* Зонинг - Процесс, бесконечный по времени и бессмысленный по содержанию.
* Извинение - фундамент для будущих проступков.
* Идея - Глупая мысль, неудобная всем. Подавший же идею приходит к этому выводу сам через какое-то время. Это время заметно сокращается, если идея реализуется.
* Катафалк - Детская колясочка смерти.
* Квест - Непонятное, но многообещающее задание для упертых игроков.
* Клан - Большая группа с длинными пальцами.
* Конкурс - ОГРОМНАЯ возможность божественной ХАЛЯВЫ.
* Кошка - Мягкий, неистребимый механизм, предоставленный нам природой, чтобы пинать его, когда что-то не ладится.
* Креш - Им заканчивается попытка богов придумать что-то новое.
* Лаг - Самое страшное изобретение Компутерного Дьявола по части мировых сетей.
* Лидер - Тот, кто подвергается наибольшей опасности и думает, что он что-то знает в этом мире. Обычно ведет за собой группу, но может жить и в одиночку. Попадаются лидеры, командующие сами собой для поднятия авторитета себя в своих глазах.
* Лог - Повседневная запись тех поступков и событий, о которых игрок может вспоминать не краснея.
* Лут - Недобровольная передача вещей трупом одного игрока потенциальному трупу другого.
* Любовь - Временное умопомешательство, излечиваемое бракосочетанием или удалением больного за пределы влияния, породившего недуг. Эта болезнь, подобно кариесу и многим другим заболеваниям, распространенна исключительно среди цивилизованных народов, живущих в неестественных условиях. Дикие племена, которые дышат чистым воздухом и едят простую пищу, обладают иммунитетом к ее губительному воздействию. Болезнь чревата роковыми последствиями, но куда чаще для врача, чем для пациента.
* Людоед - Чревоугодник старой закалки, хранящий верность простым вкусам и придерживающийся натуральной диеты доветчинного периода.
* Моб - Тупое существо, наделенное зачатками разума и неистребимым желанием жить.
* Мозг - Орган, посредством которого мы думаем, будто мы думаем.
* Молиться - Домогаться, чтобы законы Мада и Вселенной были отменены ради одного и притом явно не достойного просителя.
* Мудер (мадер) - Человек, чистящий зубы и ложащийся спать в маде.
* Мультинг - Необходимость игрока в собеседнике и соратнике, которого всегда можно похвалить.
* Муть - Проявление гласности в маде. Никто не может вам запретить говорить, пока вы сами того не захотите.
* Настоящее - Та часть вечности, что отделяет мир разочарований от царства надежды.
* Невзгоды - Процесс акклиматизации, подготавливающий душу к переходу в иной, худший мир.
* Ненависть - Чувство, естественно возникающее по отношению к тому, кто вас в чем-то превосходит.
* Нищий - Тот, кто полагается на помощь друзей.
* Ньюбис - Человек, задумчиво разглядывающий буковки на экране монитора.
* Обдумывать - Искать оправдание для уже принятого решения.
* Однажды - Достаточно.
* Оригинальность - Способ утвердить свою личность, столь дешевый, что дураки пользуются им для выставления напоказ собственной несостоятельности.
* Откат - Страх богов за физическое и умственное здоровье игроков.
* Пантеизм - Доктрина, утверждающая, что все есть бог, в отличии от другой, гласящей, что бог есть все.
* Пкилл - Инструмент проявления зависти и попытка завести знакомство, перетекающее в дружбу до гроба. Способ искоренения несправедливости, хамства и злобы, в результате которого всего этого становится намного больше. Один из способов дураков решать проблемы и доказывать всем остальным свою божественную крутость. Хотя все остальные плевать на него хотели.
* Поздравление - Вежливое проявление зависти. Помните, что Пкилл стоит чуть дальше.
* Превзойти - Нажить врага.
* Преданность - Добродетель, присущая тем, кого вот-вот должны предать.
* Предрассудок - Бродячее мнение без определенных средств к существованию.
* Презрение - Чувство благоразумного человека по отношению к врагу, слишком опасному, чтобы противиться ему в открытую.
* Признавать - Сознаваться. Признание чужых ошибок и грехов есть высший долг, налагаемый на нас любовью к истине.
* Принуждение - Красноречие силы.
* Реколл - Вещица, от которой порой зависит ваша жизнь в маде и нервы в РЛ.
* Религия - Дочь Надежды и Страха, разъясняющая Невежеству природу Непостижимого.
* Рента - Место, где вы хоть как-то имеете шанс избежать смерти и привлечения ненужного и опасного для жизни внимания. Так же место, где можно совершенно спокойно высказать обидчику все, что вы о нем думаете.
* РИП - Извечный и заложенный виртуальной природой мада процесс. Называется Круговорот Вещей. Реабилитационный период после РИПа затягивается на многие месяца у ньюбисов, однако матерые игроки проходят это период за часы и даже минуты.
* РЛ - Скучная и тяжелая реальная жизнь, от которой абстрагируются все игроки.
* Роллинг - Выбор своих параметров. Хочется лучше, а получается как всегда.. Но в теории возможна идеальность, поэтому процесс затягивается на многие дни, недели и даже месяцы. Чаще всего игроки так и не находят своего идеала и играют тем, что получилось, сожалея о том, что надо было взять то, что давали сразу, потому что там было лучше.
* Ром - Общее название горячительных напитков, доводящих до безумия людей, бросивших их употреблять.
* Рука - Приспособление для удобного использования оружия.
* Самоуважение - Неверная оценка.
* Святой - Мертвый грешник в исправленном издании.
* Соболезновать - Доказывать, что утрата - меньшее зло, чем сочувствие.
* Социал - Необходимая вещь для красочного описания негативных эмоций, потому как позитивные можно выразить словами.
* Спам - Ценное высказывание, повторенное много раз для убеждения всех в его ценности и получившее обратную реакцию.
* Спел - Изобретение дохлых людишек, которые просто физически не могут быть воинами.
* Спина - Та часть тела вашего согруппника, которую вы можете созерцать, оказавшись в беде.
* Справка - Гнусная отмазка ленивых богов, созданная для удобства игроков, но окончательно запутывающая их.
* Статсы - Жизненно важные параметры игрока, отражающие его полную неспособность заниматься выбранной профессией. Стуф - Хорошие и дорогие вещи. Дешевые и плохие называются другим словом.
* Судьба - Для Пкилера - оправдание злодейства, для ньюбиса - оправдание неудачи.
* Счастье - Приятное ощущение, вызываемое созерцанием чужих страданий.
* Съедобное - Годное в пищу и удобоваримое, как-то: червь для жабы, жаба для змеи, змея для свиньи, свинья для человека и человек для червя.
* Терпение - ослабленная форма отчаяния, замаскированная под добродетель.
* Тик - Маленький временной отрезок, отсчитывающий потерянное в маде время.
* Трусость (wimpy) - Передача функций мозга ногам.
* Усердие - Вид нервного расстройства, поражающий молодых и неопытных. Порыв, который предшествует небрежности.
* Услуга - Краткое предисловие к десяти томам вымогательства.
* Утешение - Сознание того, что человеку, который достойней вас, еще больше не везет.
* Флаг - Вешается на игрока и висит, пока какой-нибудь добрый человек его не снимет. Частенько снимается вместе с головой, вероятно по ошибке помощника.
* Хайлевел - Ньюбис, каким-то чудом достигший 25+ уровня. Чаще всего матерые игроки не отличаются таким упорством.
* Хиты - Отражают состояние здоровья пострадавшего.
* Храбрость - Одно из самых заметных качеств человека, которому ничего не угрожает.
* Христианин - Человек, верующий в Новый Завет как в божественное учение, вполне отвечающее духовным потребностям его ближнего. Человек, следующий учению Христа постольку, поскольку оно не противоречит греховной жизни.
* Холдер - Безумный и жадный ньюбис, случайно набравший два мешка стуфа и сидящий с ним у ренты. Их выдает позвякивание в мешках, огромная куча одежды на них и готовность броситься на всех: правда не выходя из ренты.
* Цена - Стоимость плюс разумное вознаграждение за угрызения совести при назначении цены.
* Циник - Мерзавец, чье ущербное зрение видит вещи такими, какие они есть, а не такими, какими им следует быть. Оттого и водился у скифов обычай вырывать цинику глаза, дабы изменить к лучшему его взгляд на мир.
* Чар - Второе Эго человека, отражающее его сущность в маде. У игроков со стажем второе Эго меняется местами с первым.
* Шум - Спам, читаемый ушами.
* Эгоист - Человек дурного тона, больше интересующийся собой, чем мной.
* Экспа - Монетка в копилку своей крутости.
* Язычник - Темный дикарь, по глупости поклоняющийся тому, что может видеть и осязать.