!! Идеи

* ОАЗИС - игра из "Первый игрок приготовьтесь"
* СлешЭмОл - Играть за героя слешеров, убивать жертв.
* Искатели Минералов - настольная игра
* Мир приключений - Гонка по этапам
* В стране дремучих трав - ботанический квест
* Рок-менеджер - менеджер рок-группы
* Боевая книга - серия приключенческих боевиков
* Прогулка по парку - пародийный боевик
* Путь героя - путешествие реинкарнирующего героя
* Стругацкиада - серия квестов
* Детектифф - расследование преступлений
* Мир Дюны - ролевая игра
* Заколдованная страна - ролевая игра
* Варварский принц - приключения принца
* Манчкин - пародийная ролевая игра
* Матрос Кошкин - квест с множеством мини-игр
* Территория - ролевой квест на небольшой площадке
* Город в осаде - квест-боевик
* Лиловый Шар - квест в стимпанковом мире
* Спецотряд - ролевая игра об Х-Ком
* Дозоры прозрачных витражей - фентези-киберпанк

Как можно неукротимую планету
* Тауэр дефенс (аля кастл паник)
* Евро на тему развития города и отстройки периметра
* боевик с прокачкой героев и всё растущими силами монстров
* экономический симулятор, где нужен баланс между развитием шахт и защитного периметра
* исследовательская лаборатория в которой мы изучаем новые виды фауны и флоры и ищем, чем их лучше всего уничтожать
* игра в генетику за монстров, против города

Рыцари Черного Замка - стратегия по пути героя

??? Заклятье черного мага