!! Толковый словарь ДМ-ских терминов

* Не дэми - не указывай
* ДМитрий - ДМский титул
* Дэмогаться - строго ДМить, преследуя кознями провинившегося игрока
* Дэминион - доминион ДМа
* Дэмоуправление - ДМский комитет
* Дэмоверсия - предположение, которое делает ДМ
* Дэмократия - политическое устройство, при котором власть принадлежит ДМу
* Дэмофон - аппарат для связи ДМа с окружающим миром
* ДэМ-монстрация (*с двумя "м") - процесс, при котором ДМ приходит в состояние озверения
* ДэМ-Морализация (*аналогично) - строгий контроль ДМа за соблюдением элайнмента
* Дембель - ДМ закончивший вождение очередной партии
* Дэмографический кризис - ДМ отказывается нарисовать карту местности
* Дэмовая шашка - любимое оружие ДМа (холодное :)
* ЗаДМление - большое количество ДМов на душу населения - kot
* ДээМография – перепись выживших игроков после очередной боёвки *) - Ян Эндрю
* ДеМография - рисование ДМом карты - Shirson
* ДэМпинг - срочная попытка найти нужную книжку в компеигроком по просьбе мастера - Princess Dragon
* ДеМпинг - попытка проверить не спит и ДМ, щелкая у него перед носом пальцами - Princess Dragon
* ДеМпинг - попытка игрока, определить находится ли ДээМ в онлайне, подавая команду ping - vart
* ДуМ - то, на что похожи игры некоторых Дмов – Drugoj_Maks
* ДаМа - девушка-ДМ – Drugoj_Maks
* ДоМ - Место, где ДМ спит – Drugoj_Maks
* ДиМм - тип памяти ДМа, в которой хранятся материалы, не предназначенные для дальнейшего употребления - броски кубиков и так далее – Drugoj_Maks
* ДайсоМет - одна из функций ДМа, не поддерживаемая в играх с нестандартным управлением, как словески - Drugoj_Maks
* ДМовой - непись - Princess Dragon
* заДэМившийся - ДМ, которого достали игроки и теперь он играет сам с собой - Olorin Starlight
* ДМухать (в оригинале укр. "дуть") - ДМу изображать сову :)) - Путник
* ДээМиЛич - Анимэйтнутый ДМ, чрезвычайно злой и безбашенный :))) - High-Jack
* ДеМилитаризация - любимое занятие ДМ-ов в FUZION - oleyansen
* ДЕМиГод - Мастер, страдающий комплексом БОГа. - oleyansen
* ДурМан - ДМ мужеска полу с низким уровнем интеллекта - Osya
* ДэМонополизация - Устройство ДМ'а на полу - Olorin Starlight
* ДаМаск - UIN ДМ'а - Olorin Starlight
* ДээМон — озверевший ДМ - Dark Pastor
* Дэмагоги — (ед.ч.) ДМ кавказской национальности - Dark Pastor
* ДээМовал — ДМы после пъянки - Dark Pastor
* ДоМино - игра ДМ'а на костяшках - Udav~
* ReаDMe.txt - файл, никогда не читаемый ДМ'мом :) – Udav~
* ДээМа Гог (по аналогии с лошадью Пржевальского :) - разновидность монстра – kot
* ДеМодуляция - Мастер ведет модуль - Shirson
* ДеМодулятор - Мастер - автор модуля - Shirson
* ДеМон - Мастер мужского пола - Shirson
* DMA (Direct Master Access) - Игрок-любимчик мастера - Shirson
* ДэМарш - ДМ-ы возвертающиеся с пиворгейзера... ;) - madcat
* ДаМба - оч. симпатишная девушка-ДМ. - madcat
* ДэМобилизация – 1) приобретение ДМ-ом мобильника (автомобиля)... - madcat 2) утеря ДээМом мобильника - Disappearer